abbreviation	n. 缩写词, 缩写, 缩短, 节略
ability	n. 能力, 才干 [经] 能力, 才能
abnormal	a. 反常的, 不规则的, 变态的, 畸形的 n. 畸形的人
abolish	vt. 废止, 革除, 消灭 [经] 废除, 取消, 裁撤
aboriginal	a. 原始的, 土著的 n. 土著居民, 土生生物
abort	vi. 流产, 中途失败 vt. 使流产, 使失败, 使中止
abortion	n. 流产, 堕胎, 失败, 夭折, 中止 [医] 流产, 小产; 顿挫
abound	vi. 大量存在, 富于, 充满
abrasion	n. 磨擦, 磨损, 磨损处 [化] 磨耗; 磨蚀
abridge	vt. 缩短, 删节, 减少, 剥夺 [法] 剥夺; 节略
abrupt	a. 突然的, 唐突的, 陡峭的, 不连贯的
absorb	vt. 吸收, 使全神贯注, 同化, 买进, 理解, 承受, 忍受, 承担 [医] 吸收
abstract	a. 抽象的, 深奥的 n. 摘要, 抽象概念 vt. 摘要, 提炼, 使抽象化 [计] 摘录; 摘要; 抽象
absurd	a. 荒谬的, 不合理的, 可笑的 n. 荒诞
abundance	n. 丰富, 充足, 大量 [经] 丰富, 充裕
abuse	n. 滥用, 虐待, 恶习, 辱骂 vt. 滥用, 辱骂, 虐待
academic	a. 学院的, 学术的, 不切实际的 n. 大学生, 大学教师, 学者, 学会会员
accelerate	v. 加速, 促进
access	n. 通路, 入口, 接近, 进入, 使用权, 发作 vt. 访问, 存取, 接近, 使用 [计] 访问, 存取
accessible	a. 易接近的, 可进入的, 可使用的, 易受影响的, 可理解的
accessory	n. 附件, 零件, 附加物, 从犯, 同谋 a. 附属的, 补充的, 同谋的, 帮凶的, 非主要的, 副的 [计] 附件
accidents	n. 意外事故；事故（accident的复数）
acclaim	n. 喝彩, 欢呼, 赞同 v. 欢呼, 喝彩, 称赞
accommodate	vt. 使适应, 调和, 通融, 容纳, 向...提供 vi. 适应
accommodation	n. 膳宿, 预订铺位, 适应性调节, 调和, 贷款 [医] 调节(眼); 适应
accommodations	n. 膳宿；住房, 住宿；居住设施（accommodation的复数）
accompany	vt. 陪伴, 伴随, 补充, 为...伴奏 vi. 伴奏, 伴唱
accomplish	vt. 完成, 达到, 实现, 使完美
accord	n. 一致, 调和, 协定 vt. 给与, 使一致 vi. 相符合
account	n. 报告, 解释, 估价, 理由, 利润, 算账, 帐目 vi. 报帐, 解释, 导致, 报偿, 占, 杀死 vt. 认为 [计] 帐户, 帐号
account for	对…负有责任；对…做出解释；说明……的原因；导致；（比例）占
accountant	n. 会计人员, 会计师 [经] 会计师, 会计人员
accountants	会计人员
accounting	n. 会计学, 帐单, 清帐 [计] 帐户处理, 记帐
accumulate	v. 积聚, 堆积
accuracy	n. 精确, 正确 [计] 准确度
accurate	a. 正确的, 精确的 [经] 准确的, 精确的
accuse	vt. 指责, 控告, 归咎于 vi. 指责, 控告
accuser	n. 控诉者, 指责者 [法] 原告, 指控人, 控告者
achieve	vt. 完成, 达到 vi. 如愿以偿
achievement	n. 完成, 成就, 功业
acid	n. 酸, 酸类物质, 尖刻, 迷幻药 a. 酸的, 酸性的, 尖刻的, 敏锐的 [计] 自动文档互参与索引生成程序
acknowledge	vt. 承认, 告知收悉, 答谢, 报偿 [经] 承认, 答谢, 收到的通知
acquaint	vt. 使认识, 介绍
acquire	vt. 获得, 学到 [电] 目标锁定
acquisition	n. 获得, 获得物 [经] 收购, 招揽, 取得
action	n. 行动, 活动, 动作, 作用, 战斗, 行为, 诉讼 vt. 对...起诉 [计] 方式
actions	n. 动作；行动（action的复数）
activate	vt. 使活动, 使激活, 正式建成 vi. 有活力
activities	n. （activity复数形式）活动；活动区；活动性
activity	n. 活动, 行动, 活跃, 活力 [计] 活动
actor	n. 男演员, 行动者 [医] 作用物, 反应物
acute	a. 尖锐的, 敏锐的, 激烈的, 严重的, 急性的 [医] 急性的; 尖锐的
adapt	vt. 使适应, 改编 vi. 适应
addict	vt. 使沉溺, 使上瘾 n. 入迷的人, 上瘾者
addition	n. 加法, 增加的人(或物) [计] 加法
additional	a. 附加的, 另外的, 额外的 [机] 加添的, 附加的
address	n. 住址, 演说, 举止, 灵巧, 求爱 vt. 发表(演说或讲话), 对付, 写地址 [计] 地址, 寻址
adept	a. 熟练的, 老练的, 巧妙的 n. 能手, 内行
adequate	a. 适当的, 足够的 [法] 胜任的, 适当的, 充分的
adhere	vi. 依附, 粘着, 坚持, 追随, 拥护 vt. 使粘附
adjacent	a. 毗连的, 邻近的, 连接的 [机] 相邻的, 邻位的, 交界的
adjoin	v. 邻接, 毗连
adjust	vt. 调整, 使适应于, 校准 vi. 适应于, 被调节, 相互熟悉而适应
administer	vt. 管理, 料理, 执行 vi. 执行遗产管理人的职责, 给予帮助
administration	n. 行政, 管理, 政府机关 [化] 给药
administrator	n. 管理人, 行政官 [经] 遗产管理人员
admission	n. 准许进入, 入场费, 录用, 承认 [经] 加入, 入股
adolescence	n. 青春期 [医] 青年期, 青春期
adopt	vt. 采用, 正式通过, 收养, 接受 [医] 采取
adore	vt. 崇拜, 爱慕, 喜爱 vi. 崇拜, 爱慕
adult	n. 成人, 成虫 a. 成年的, 成熟的
adults	n. 成年人（adult的复数形式）
advanced	a. 在前的, 高级的, 先进的, 年老的 [法] 预付的, 预支的, 垫付的
advantages	n. 优势；特点；有利；[经] 利益（advantage的复数） v. 促进（advantage的三单形式）；有利于
advent	n. 来到, 来临
adverse	a. 不利的, 敌对的, 相反的, 逆的 [法] 相反的, 敌对的, 逆的
advertise	vt. 做广告, 通知, 公布 vi. 做广告
advertisement	n. 广告, 启事, 广告宣传 [法] 广告, 公告, 告示
advertisements	n. [经] 广告（advertisement的复数）；宣传
advertising	n. 广告业, 广告 a. 广告的 [计] 发广告
advice	n. 忠告, 劝告, 意见, 报道, 通知 [经] 通知书, 通知, 建议
advocate	n. 提倡者, 拥护者 vt. 主张, 提倡
aerial	a. 空中的, 航空的, 空气的, 空想的 n. 天线
aesthetic	a. 美学的, 审美的, 有美感的
affairs	n. 事务, 事宜；风流韵事
affect	vt. 影响, 感动, 假装, 模仿, 爱好, 倾向于 n. 自觉感情
affection	n. 影响, 病, 喜爱, 情感, 倾向 [医] 疾患, 病变, 病; 感情
affiliate	vt. 使紧密联系, 使附属, 接纳, 收养 vi. 发生联系, 参加
affirm	v. 断言, 确认
affix	vt. 使附于, 署名, 粘贴, 盖印于 n. 附加物, 词缀
afflict	vt. 使苦恼, 折磨
afford	vt. 买得起, 足以, 给予
Africa	n. 非洲
African	n. 非洲人 a. 非洲的, 非洲人的
age	n. 年龄, 老年, 成年, 寿命, 时代, 时期 v. 变老, 成熟
agencies	n. 代理；代理处（agency的复数）
agency	n. 代理机构, 经销商, 中介 [化] 办事处
agenda	pl. 议程, 日常工作事项 [计] 待议事件
aggravate	vt. 使恶化, 使更严重, 加重
aggregate	n. 合计, 总计, 聚集体 a. 合计的, 聚集的 v. 聚集, 集合, 合计达 [计] 聚合体; 聚集
aggressive	a. 侵略的, 挑畔的, 进取的 [法] 侵略的, 爱挑衅的, 行为过火的
agitation	n. 激动, 焦虑, 煽动, 搅动, 摇动 [化] 搅拌; 搅拌作用
agony	n. 极大的痛苦, 挣扎 [医] 濒死苦闷; 剧痛
agreeable	a. 令人愉快的, 同意的 [医] 佳适的
agreement	n. 同意, 合约, 协议 [经] 契约, 协议, 协定
agriculture	n. 农业 [机] 农业, 农学
AIDS	n. 爱滋病(获得性免疫缺陷综合征) [计] 高级综合数据系统, 先进交互调试系统, 自动图解文档编制系统 美国决策学学会, 信息自动显示系统, 自动综合调试系统
aim	n. 目标, 瞄准, 击中目标的能力 vi. 对准目标, 致力, 打算 vt. 瞄准 [计] 医学文摘索引, 存取隔离机构, 高级信息管理程序, 先进接口模块 应用接口模块, 医学人工智能, 相联索引法, 异步接口模块 自动化信息管理, 自动化综合制造, 自动化库存管理
air	n. 空气, 旋律, 态度 vt. 晾, 使通风, 夸耀
airport	n. 飞机场 [机] 航空站, 机场
aisle	n. 走廊, 侧廊, 过道 [机] 走道
alarm	n. 惊恐, 警报, 警钟 vt. 使惊恐, 警告 [计] 报警信号
Alaska	n. 阿拉斯加州
album	n. 粘贴簿, 唱片套 [医] 白色物
alien	n. 外国人, 外侨 a. 外国的, 相异的
alienate	vt. 使疏远, 离间, 转让 [法] 转让, 让与, 疏远
all	a. 所有的, 全部的, 一切的 adv. 全部, 全然 pron. 全部 n. 全部
allege	vt. 宣称, 主张, 提出, 断言 [法] 断言, 指称, 指证
allegiance	n. 忠贞, 效忠
allergic	a. 对...过敏的, 极反感的 [医] 变应性的
allergy	n. 变应性, 反感, 厌恶 [化] 变态反应; 变应性
alleviate	vt. 减轻, 使缓和
alley	n. 小路, 巷
alliance	n. 联盟, 联合 [法] 同盟, 联盟, 联姻
allocate	vt. 分派, 分配 [计] 分配
allot	vt. 分配, 分摊指定 [经] (按股或按规定)分配, 配(拨)给, 规(派)定
allowance	n. 津贴, 零用钱, 限额, 折扣, 允许 vt. 定量供应
alloy	n. 合金 vt. 将...铸成合金, 减低成色 vi. 合铸
ally	n. 同盟者, 同盟国, 助手 vt. 使联盟, 使联合, 使有关系 vi. 结盟
alone	a. 孤独的, 单独的, 独自的 adv. 独自地
alongside	adv. 在旁边, 靠拢着 prep. 在...旁边, 与...在一起
alphabetical	a. 依字母顺序的, 字母的
alter	v. 改变
alternate	a. 交替的, 轮流的, 间隔的 v. 轮流, (使)交替
alternative	n. 两者择一, 供替代的选择 a. 两者择一的, 供选择的 [计] 选择对象
altitude	n. 高度, 海拔, 高处 [电] 高度
amateur	n. 业余爱好者, 外行, 爱好者 [电] 业余家
amaze	vt. 使吃惊
amazing	a. 令人惊异的
ambassador	n. 大使 [法] 大使, 使节, 代理
ambiguity	n. 不明确, 含糊 [计] 二义性; 多义性
ambiguous	a. 不明确的, 模棱两可的 [法] 意思含糊的, 模棱两可的, 暧昧的
ambition	n. 野心, 志向
ambitious	a. 有野心的, 抱负不凡的, 雄心勃勃的
ambulance	n. 救护车 [医] 救护车
amend	vt. 修改, 改善, 改良 vi. 改过自新
amends	n. 赔偿 [经] 赔偿
America	n. 美洲, 美国
American	n. 美国人 a. 美国的, 美洲的
amid	prep. 在其间, 在其中 [经] 在...中
amidst	prep. 在...当中
ammunition	n. 军火, 弹药 [机] 弹药
amount	n. 总数, 总额 vi. 总计, 等同
amphibian	a. 两栖类的, 水陆两用的 n. 两栖动物, 水旱两生植物, 水陆两用飞机
ample	a. 大量的, 充足的, 丰富的
amplify	vt. 增强, 放大, 扩大, 详述 vi. 引伸
amuse	vt. 消遣, 娱乐, 使发笑
analogy	n. 相似, 类似 [计] 模拟
analysis	n. 分析 [计] 分析机; 分析员; 分析; 分析程序
analytical	a. 分析的, 善于分析的, 解析的 [机] 分析的
ancestor	n. 祖先, 祖宗
anchor	n. 锚 vt. 抛锚停泊, 使固定 [计] 锚
ancient	a. 古代的, 古老的, 年老的, 旧的
anecdote	n. 轶事, 奇闻
anger	n. 忿怒 vt. 激怒, 使发怒 vi. 发怒
angry	a. 生气的, 愤怒的
animal	n. 动物 [医] 动物
animals	n. 动物, 动物世界；牲畜（animal的复数形式）
ankle	n. 踝 [医] 踝, 踝关节
annihilate	vt. 消灭, 废止
anniversary	n. 周年纪念
announcement	n. 公告, 发表, 告知 [经] 通告, 布告, 公告
annoy	vt. 使恼怒, 骚扰
annual	n. 年刊, 年报 a. 每年的, 一年一次的, 全年的, 一年生的
annuity	n. 年金, 年金保险, 年金领受权 [医] 年金, 年俸
anonymous	a. 姓氏不详的, 无名的, 无特色的 [计] 无记录
antagonism	n. 对立, 敌对, 敌意 [化] 拮抗作用; 消效作用
antarctic	a. 南极的, 南极地带的 n. 南极地区
antecedent	n. 前情, 先行词 a. 先前的, 先行的
anthem	n. 圣歌, 赞美诗
anthology	n. 选集, 诗选
anthropology	n. 人类学 [医] 人类学
antibiotic	n. 抗生素 a. 抗生的
antibiotics	n. 抗生学；抗生素
anticipate	vt. 预期, 占先, 加速, 提前使用 [医] 提前出现, 先期发生
anticipation	n. 预期, 预料 [医] 提前出现(如遗传病)
antique	n. 古董, 古物 a. 古老的, 古风的, 旧式的, 过时的
antonym	n. 反义词
anxiety	n. 焦虑, 忧虑, 令人焦虑的事 [医] 焦虑
anyhow	adv. 无论如何, 至少
apartment	n. 房间, 公寓
ape	n. 无尾猿 [计] 应用程序评价
apes	n. 猿( ape的名词复数 ) v. 模仿( ape的第三人称单数 )
apologetic	a. 道歉的, 急于认错的, 辩护的 [法] 辩护的, 辩解的, 道歉的
apostrophe	n. 撇号, 呼语法
apparatus	n. 装置, 器具, 器官 [化] 仪器; 器械
apparent	a. 清晰可见的, 显然的, 表面上的 [电] 外在的
appeal	n. 恳求, 诉请, 上诉, 吸引力 vi. 呼吁, 诉请, 要求, 上诉, 有吸引力 vt. 将...上诉
appearance	n. 出现, 露面, 外观, 外表, 出版 [计] 外观, 版面
appendix	n. 附录, 附加物, 阑尾 [化] 增补
appetite	n. 食欲, 欲望, 爱好 [医] 食欲
applaud	v. 拍手喝彩, 称赞, 赞同
appliance	n. 器械, 用具, 应用 [医] 矫正器; 器
applicant	n. 申请者 [经] 申请人, 请求人, 谋事人
application	n. 应用, 申请, 志愿书, 应用程序 [计] 应用, 应用程序
applied	a. 应用的 [机] 应用的; 应用, 申请
apply	vt. 涂, 应用 vi. 申请, 适用
appointment	n. 约会, 委任的职位, 委派 [经] 任命, 派, 指定
appraisal	n. 评价, 估价 [经] 评价, 评估
appreciable	a. 可感知的, 可评估的
appreciate	vt. 赏识, 鉴别, 为...而感激, 领会, 欣赏 vi. 增值, 涨价
apprehension	n. 理解, 忧惧, 逮捕 [医] 领会
apprentice	n. 学徒, 生手 vt. 使做学徒
approach	n. 接近, 入门 vt. 接近, 近似, 找...商量 vi. 靠近
approaches	处理
appropriate	a. 适当的 [经] 适当的, 拨出, 占用
approval	n. 赞成, 批准 [化] 核准
approximate	a. 大约的, 接近的, 近似的 vt. 接近, 使接近, 粗略估计 vi. 接近于
April	n. 四月
apt	a. 有...倾向的, 易于的, 恰当的, 聪明的 [计] 自动数控语言, 自动图象传输, 自动程序控制, 自动程序设计工具
aptitude	n. 资质, 才能, 自然倾向 [医] 资质, 才能
aquarium	n. 水族馆, 养鱼池, 水草缸 [医] 培养缸
aquatic	n. 水生动物, 水生植物 a. 水生的, 水中的, 水上的
arbitrary	a. 任意的, 武断的, 专治的, 霸道的
arc	n. 弧, 弧形, 弓形, 弧光 [化] 弧
arch	n. 拱门, 拱形, 足弓 vt. 使成弓形 vi. 拱起, 成弓形 a. 主要的, 调皮的, 傲慢无礼的, 狡猾的
archaeological	a. 考古学的, 考古学上的
archaic	a. 古体的, 过时的, 古老的, 古代的 [医] 原始的, 古代的
architect	n. 建筑师, 设计者, 缔造者
architecture	n. 建筑学, 建筑式样 [计] 体系结构
archives	n. 档案, 档案室 [法] 公文档案, 案卷, 档案保管处
arctic	a. 北极的, 极寒的 n. 北极圈, 北极
ardent	a. 热心的, 激动的, 燃烧般的 [医] 灼热的; 热心的
arduous	a. 费力的, 努力的, 险峻的
area	n. 区域, 面积, 范围, 空地 [计] 区域
areas	n. 区域, 领域；面积（area的复数形式）
arena	n. 角斗场, 舞台, 场地 [医] 尿沉渣, 尿沙; 脑沙
argue	vi. 提出理由, 争论, 辩论 vt. 主张, 辩论, 证明, 说服
argument	n. 争论, 论证, 论据, 自变量 [计] 参数
arise	vi. 站立, 出现, 起来
armour	n. 甲胄, 装甲, 潜水服
army	n. 军队, 陆军
arouse	vt. 唤醒, 鼓励, 引起 vi. 醒来
array	n. 排列, 衣服, 大批, 军队 vt. 布署, 打扮, 排列 [计] 数组; 阵列
arrival	n. 到达, 抵达, 到达者 [经] 到达, 到达物
arrogant	a. 自大的, 傲慢的
art	n. 艺术, 人文科学, 技术, 巧妙, 诡计, 美术 [计] 实际保持时间, 特许权和资源表, 平均检索时间, 平均运行时间
artery	n. 动脉, 干道, 要道 [医] 动脉
article	n. 文章, 冠词, 物品, 物件, 条款, 契约 [计] 信件
articles	n. 文章；冠词；物品；条款（article的复数）
articulate	a. 发音清晰的, 口才好的 vt. 明白地说, 以关节连接, 使成为系统的整体
artificial	a. 人造的, 假的, 非原地产的 [医] 人工的, 人造的, 伟牟
artillery	n. 火炮, 炮兵, 炮术 [机] 火炮, 炮兵
artistic	a. 艺术的, 艺术家的, 富有艺术性的
as	adv. 同样地, 例如 prep. 做为, 当作 conj. 当...之时, 以...的方式, 像...一样, 因为 [计] 高级系统, 先进系统, 辅助存储器, 自治系统
ascend	vi. 上升, 追溯, 登高 vt. 攀登
ascent	n. 上升, 提高, 攀登, 上坡路
ascertain	vt. 确定, 查明 [法] 查明, 弄清, 确定
ascribe	vt. 归因于, 归咎于 [法] 归咎于
ashamed	a. 惭愧的, 羞耻的
Asia	n. 亚洲
aspiration	n. 热望, 志向, 渴望 [医] 吸入; 吸[引], 吸引术
aspire	vi. 渴望, 立志于
aspirin	n. 阿斯匹林 [化] 乙酰水杨酸; 阿司匹灵; 邻乙酸基苯甲酸
assassination	n. 暗杀 [法] 暗杀, 行刺
assault	n. 攻击, 袭击 vt. 袭击, 攻击 vi. 发动攻击
assemble	vt. 集合, 收集, 装配 vi. 集合 [计] 汇编
assert	vt. 主张, 坚称, 断言 [法] 宣称, 断言, 维护
assess	vt. 估定, 对...征税, 评定 [经] 估计, 估价, 确定(税款罚款等)的金额
assessment	n. 评估, 估定, 评定的款额 [化] 评估
asset	n. 资产, 有益的东西
assign	vt. 分配, 指派, 赋值 [计] 赋值
assignment	n. 分配, 功课, 任务, 转让, 归因, 陈述 [计] 赋值
assignments	n. 分配；作业（assignment的复数形式）
assimilate	vt. 使同化, 吸收, 使相拟, 把...比作 vi. 被吸收, 被同化
assistance	n. 协助, 援助 [经] 援助, 帮助
assistant	n. 助手, 助理, 助教 a. 有帮助的, 辅助的, 助理的
associate	n. 同伴, 伙伴, 关联的事物 vt. 使联合, 使发生联系 vi. 交往 [计] 关联
association	n. 协会 [计] 关联
assorted	a. 各种各样的, 分类的
assume	vt. 假定, 承担, 呈现 vi. 装腔作势, 僭越
assumption	n. 假定, 自负, 担任, 假装 [经] 假定, 承担
assurance	n. 保证, 把握, 信心, 保险 [经] 保证, 担保, 保险
assure	vt. 保证, 使确信, 弄清楚, 担保 [法] 确信, 保证, 保障
astound	vt. 使惊骇, 使大惊
astronomy	n. 天文学
asylum	n. 庇护, 收容所 [医] 养育院
Athens	n. 雅典(希腊首都)
athlete	n. 运动员, 运动选手 [医] 运动员
atlas	n. 地图集, 图表集 [计] 自动测试和负载分析系统
atmospheric	a. 大气的 [医] 大气的; 大气压的
attach	vt. 附上, 使依附, 使附属, 使喜爱, 系, 缚 vi. 附属, 归属, 联系在一起 [计] 挂接服务器命令, 关联, 挂接, 附加
attack	n. 攻击, 抨击 vt. 攻击, 抨击, 动手干 vi. 攻击
attacks	n. 攻击, 评击（attack的复数形式）
attain	vt. 达到, 获得 vi. 达到
attempt	n. 尝试, 企图 vt. 尝试, 企图
attempts	n. 企图, 试图；尝试（attempt的复数） v. 试图；努力去做（attempt的三单形式）
attend	vt. 参加, 照料, 伴随 vi. 专心于, 照顾, 服侍, 出席
attendance	n. 出席, 出席的人数, 照料 [法] 管理, 照料, 资助
attendant	n. 随从, 侍者, 出席者 a. 侍候的, 伴随的, 出席的, 在场的
attention	n. 注意, 注意力 [计] 引起注意信号
attentive	a. 注意的, 留心的
attorney	n. 代理人, 律师 [经] 律师, 代理人
attractive	a. 吸引人的, 有魅力的 [法] 有吸引力的, 有迷惑力的
attribute	n. 属性, 标志, 定语 vt. 把...归于, 认为...属于 [计] 属性
auction	n. 拍卖 vt. 拍卖
audible	a. 听得见的 [电] 可闻的
audience	n. 听众, 观众, 读者 [法] 听讼, 观众, 听众
audio	a. 音频的, 声音的 [电] 声频
audit	n. 审计, 查帐 vt. 查(帐), 旁听 vi. 查账 [计] 查帐; 审查; 检查
audition	n. 听, 听力, 试听 [计] 审计命令
auditorium	n. 听众席, 礼堂 [医] 大讲堂, 大会堂
augment	v. 增加, 增长 [计] 增加; 增量; 添加
august	n. 八月 a. 威严的, 令人敬畏的
Australia	n. 澳洲, 澳大利亚
Australian	n. 澳大利亚人 a. 澳大利亚的, 澳洲的, 澳洲人的
authentic	a. 可靠的, 可信的, 真正的 [法] 被认证的, 确认的, 可信的
author	n. 作家, 作家的著作, 创始人 [法] 作者, 著作人, 本人
authoritative	a. 权威性的, 官方的, 命令式的 [法] 官方的, 当局的, 权威的
authority	n. 权力, 当权者, 当局, 权威, 专家 [经] 代理权, 授权, 权威
authorize	vt. 授权, 批准, 委托 [经] 授权, 委任, 认可
automatic	n. 自动手枪, 自动机械 a. 自动的, 机械的, 必然的, 无意识的
automation	n. 自动化, 自动操作 [计] 自动学; 自动化
automobile	n. 汽车 [机] 汽车
autonomy	n. 自治, 自治权 [医] 自主性
auxiliary	n. 辅助者, 辅助物, 附属机构, 助动词 a. 辅助的, 备用的
avail	vi. 有用, 有利 vt. 有利于 n. 效用, 利益
available	a. 可利用的, 可获得的, 有效的 [医] 有效的, 可得的
avalanche	n. 雪崩, 山崩, 大量 vi. 崩塌 vt. 大量涌至
avenue	n. 大街, 途径, 林荫路
average	n. 平均, 平均数, 一般水平, 海损 a. 平均的, 中等的, 平常的 vt. 算出...平均数, 平均做, 均分, 使平衡 vi. 平均为, 呈中间色
avert	vt. 转开, 避免, 防止
aviation	n. 航空, 航空学, 飞行术 [法] 航空, 飞行, 飞行术
avoid	vt. 避免, 防止, 撤消 [法] 避免, 回避, 躲开
award	n. 奖品, 裁定, 判决 vt. 授予, 给予
aware	a. 知道的, 有觉悟的
awareness	n. 意识, 认识 [计] 识别, 议定, 明白
awful	a. 可怕的, 庄严的, 虔敬的
awkward	a. 笨拙的, 棘手的
axis	n. 轴 [计] 坐标轴
back	a. 后面的 vt. 使后退, 支持 vi. 倒退, 背靠 adv. 向后地 n. 背部, 后面
background	n. 背景, 背景资料 [计] 背景, 后台
backward	adv. 向后地, 相反地 a. 向后的, 相反的 [计] 倒推
bacon	n. 熏猪肉 [机] 腌肉
bacteria	pl. 细菌 [医] 细菌, [无芽胞]杆菌
bacterium	n. 细菌 [医] [无芽胞]杆菌属
badge	n. 徽章, 标记 [计] 标记
badminton	n. 羽毛球运动
baffle	vt. 困惑, 为难, 使挫折 vi. 徒作挣扎 n. 迷惑, 挡板
baggage	n. 行李 [经] 行李
bait	n. 饵 vt. 以饵引诱, 欺负 vi. 中途休息
bake	vt. 烘焙, 烤 vi. 烤面包 n. 烘焙, 烤
balance	n. 平衡, 差额 vi. 平衡, 相等 vt. 称, 权衡, 比较, 使平衡, 结算, 抵消
balcony	n. 阳台, 戏院楼厅
bald	a. 秃头的, 光秃的, 单调的, 赤裸的 vi. 变秃
baldness	n. 光秃, 率直, 枯燥 [医] 秃[发], 脱发
ballet	n. 芭蕾舞
balloon	n. 气球 vt. 使成气球状 vi. 膨胀如气球, 激增
ballot	n. 投票, 投票用纸, 抽签 vi. 投票, 抽签 vt. 投票选出, 拉选票
ballroom	n. 舞厅, 跳舞场
bamboo	n. 竹子 [医] 竹类
ban	n. 禁令 vt. 禁止, 取缔
band	n. 带子, 队, 乐队 v. 联合, 结合 [计] 频带; 波段; 区
bandage	n. 绷带 [化] 帘布筒; 实心轮胎; 紧带; 绷带
bands	n. 法官；乐队
bang	n. 重击, 突然巨响, 刘海 v. 发巨响, 重击 adv. 砰然地, 突然巨响地, 直接地 [计] 撞击符
banish	vt. 驱逐, 消除 [法] 驱逐, 流放
bank	n. 银行, 堤, 岸 [医] 库
banking	n. 银行业务 [经] 银行业, 银行事务
bankrupt	n. 破产者 a. 破产的 vt. 使破产
banner	n. 旗帜 a. 显著的, 特别好的
banquet	n. 宴会
bar	n. 条, 棒, 酒吧, 栅, 障碍物 vt. 禁止, 阻挡, 妨碍 [计] 棒形图
barbecue	n. 烤肉 vt. 烤肉, 烧烤
barber	n. 理发师
bare	a. 赤裸的, 缺少的, 无遮蔽的, 坦率的 vt. 使赤裸, 露出
barely	adv. 几乎不
bargain	n. 交易, 买卖协定, 特价商品 v. 讲价, 交易
bark	n. 树皮, 吠声 vi. 吠, 叫骂 vt. 喊出, 剥树皮
barn	n. 谷仓 [化] 靶(恩)(核反应截面单位)
barometer	n. 气压计 [化] 气压计
barrel	n. 桶 vt. 装入桶内
barren	a. 不育的, 贫瘠的 n. 荒地
barricade	n. 路障, 障碍 vt. 设路障于, 阻碍
barrier	n. 障碍, 栅栏 [化] 势垒; 阻片; 阻挡层
barter	n. 物物交换, 实物交易 v. 物物交换, 交换
baseball	n. 棒球 [计] 棒球系统
basement	n. 地下室, 墙脚 [化] 地下室
basic	n. 基本原理, 要素, 基本规律 a. 基本的, 碱性的 (计算机)BASIC语言
basis	n. 基础, 主要成分 [化] 基底
batch	n. 一次所烘的面包, 一次所制之量, 一组, 批, 成批, 分批 v. 成批, 分批处理 [计] 一批
bath	n. 沐浴, 浴室 [医] 浴
bathe	vt. 沐浴, 用水洗 vi. 洗澡
bathroom	n. 浴室, 厕所
batter	v. 连续猛打（尤其指妇女），猛击 n. 面糊（食物），击球员，打击手
battery	n. 电池, 殴打 [化] 蓄电池
bay	n. 海湾, 狗吠声, 月桂 vt. 吠, 使走投无路 vi. 吠
beach	n. 海滩
bead	n. 珠子, 滴 vt. 用珠装饰 vi. 形成珠 [计] 珠
beam	n. 横梁, 杆, 光线, 容光焕发 vi. 用梁支承, 微笑, 射出光线 vt. 照耀, 感到欣喜 [计] 束
bear	n. 熊 vt. 忍受, 支承, 产生, 怀有, 通过卖空使跌价 vi. 忍受, 结果实, 压挤, 行进, 转向
beard	n. 胡须 vt. 抓住胡须, 公开反对
bearing	n. 举止, 轴承, 忍受, 关系, 意义, 方向, 生育 [化] 轴承
beat	n. 心跳(声), 打, 敲打声, 拍子 v. 打, 拍打, 打败 a. 疲乏的, 颓废的 beat的过去式 [计] 拍; 节拍
beats	n. 音乐节拍；差拍振动；心脏跳动（beat的复数）
beautiful	a. 美丽的
beauty	n. 美, 美人
become	vi. 变成, 变得 vt. 适合
bedroom	n. 卧室
beds	n. 床上用品, 床组（bed复数）
bedsit	n. 卧室兼起居室 vt. 租用卧室兼起居室
beforehand	adv. 预先
beginners	n. 初学者；生手；首创者（beginner的复数）
beginning	n. 开始
behalf	n. 利益, 方面
behave	vi. 举止端正, 行为规矩 vt. 检点(自己的)行为, 使表现好
behavior	n. 行为, 举止 [医] 行为
belly	n. 腹部, 食欲 vt. 使鼓起 vi. 鼓起, 匍匐前进
beloved	a. 心爱的 n. 心爱的人
belts	n. 带子；皮带（belt的复数）
bend	vi. 变弯曲, 屈服 vt. 使弯曲, 使屈服 n. 弯曲
beneficial	a. 有益的, 受益的 [经] 有使用权的, 可享利益的
benefit	n. 利益 vt. 有益于 vi. 受益
benefits	n. 利益, 收益；福利, 效益（benefit的复数形式）
bent	a. 弯曲的, 决心的 n. 爱好 bend的过去式和过去分词
Berlin	n. 柏林, (软质)柏林毛线
berth	n. 船岸之间的水区, 锚地, 卧铺 vi. 停泊 vt. 使停泊
beset	vt. 围绕, 使苦恼, 镶嵌
best	a. 最好的 adv. 最好地 n. 最好的人
bet	n. 打赌, 赌注 v. 打赌
betray	vt. 出卖, 背叛, 辜负, 暴露 [法] 出卖, 背叛, 泄漏
better	a. 较好的 adv. 比较好
beverage	n. 饮料 [化] 饮料(如牛奶、茶、咖啡、啤酒等)
bewilder	vt. 使迷惑, 使不知所措
bias	n. 偏见, 斜纹 a. 偏斜的 adv. 偏斜 vt. 使有偏见 [计] 偏流; 偏压; 偏磁; 偏离
bible	n. 圣经
bibliography	n. 参考书目 [计] 书目; 文献目录
bicycle	n. 自行车
bicycles	n. 自行车；脚踏车（bicycle的复数）
bid	n. 出价 v. 命令, 吩咐, 请求, 表示, 宣布, 投标
bilateral	a. 有两边的, 双边的, 双方的 [医] 两侧的
bilingual	a. 双语的
bill	n. 帐单, 清单, 钞票, 鸟嘴, 广告, 法案, 票据 vt. 开帐单, (用招贴)宣布
bind	vt. 绑, 约束, 装订, 包扎, 使结合 vi. 凝固, 有约束力 [计] 赋值, 绑定
biography	n. 传记
biological	a. 生物学的 [医] 生物学的
biology	n. 生物学 [化] 生物; 生物学
birds	n. 鸟类；禽（bird的复数）
Birmingham	n. 伯明翰
birth	n. 出生, 起源 [医] 生产, 分娩
bite	n. 咬, 一口 v. 咬, 刺痛, 穿透
bitter	a. 苦的, 痛苦的, 怀恨的 adv. 刺骨 v. (使)变苦
bitumen	n. 沥青 [化] 沥青; 石油沥青
bizarre	a. 奇异的
black	n. 黑色, 黑颜料 a. 黑色的
blame	n. 过失, 责备 vt. 责备, 归咎于
blank	n. 空格, 空白 a. 空白的, 空虚的, 完全的, 无色的 vi. 消失, 成为空白 vt. 使无效, 取消, 封锁 [计] 空白
blanket	n. 毛毯, 毯子 vt. 掩盖, 覆盖 a. 总共的
blast	n. 一阵风, 爆炸, 枯萎病 vt. 炸, 使枯萎 vi. 炸, 猛攻, 猛烈抨击, 枯萎
blaze	n. 火焰, 烈火, 光辉 vi. 燃烧, 发光 vt. 使燃烧, 宣布, 在树皮上刻痕
bleach	vt. 漂白 vi. 变白 n. 漂白, 漂白剂
bleak	a. 萧瑟的, 荒凉的, 阴冷的
bleed	vi. 流血, 悲痛, 渗出 vt. 使出血, 榨取
blend	vt. 混合 n. 混合
bless	vt. 祝福, 祈佑, 使神圣化
blind	n. 蒙蔽物, 窗帘 a. 盲目的, 瞎的, 不加思考的 vt. 使失明, 蒙蔽, 遮暗 adv. 盲目地
blink	vi. 眨眼, 闪亮 vt. 眨眼, 使闪亮 n. 眨眼, 瞬间, 闪光, 闪烁 [计] 闪烁
bloc	n. 集团
block	n. 街区, 木块, 石块, 块 vt. 阻塞, 封锁, 使成块状 [计] 块, 数据块
blocks	n. 积木；黑金石；街区；[音]双头木鱼；楼群（block的复数）
blond	a. 金发的 n. 白肤碧眼金发的人
blonde	a. (头发)亚麻色的, 淡色的, 白肤金发碧眼的, 白里透红的, 白皙的, 淡黄色的 n. 肤色白皙的金发女人
blood	n. 血, 血统, 流血, 气质, 生命 vt. 使出血, 用血涂
bloom	n. 花, 开花, 青春, 钢块 vi. 开花, 焕发青春, 茂盛 vt. 使茂盛, 把...轧成钢坯
blossom	n. 花, 花开的状态, 兴旺期 vi. 开花, 兴旺, 发展
blot	n. 污点, 墨水渍 vt. 乱涂, 使模糊, 吸干 vi. 弄上墨渍, 吸墨水
blouse	n. 宽松的上衣
blunder	n. 大错, 大失策 vi. 失策, 跌跌撞撞地走, 犯错 vt. 做错
blunt	a. 钝的, 坦率的, 麻痹的
blur	vt. 使模糊, 弄脏 vi. 弄脏, 模糊
blush	vi. 脸红, 羞愧 vt. 弄成红色 n. 脸红
board	n. 木板, 甲板, 膳食, 会议桌 vt. 乘船, 供膳食, 用板覆盖 vi. 搭伙 [计] 板
boast	n. 吹牛 vi. 吹牛, 自夸 vt. 夸口说, 自恃有
boat	n. 船 vi. 乘船 vt. 以船运
boil	n. 煮沸, 沸腾, 疖 v. 煮沸, 激动
bold	a. 大胆的 n. 粗体 [计] 粗体
bolt	n. 门闩, 螺钉, 筛子, 闪电, 意外事件 vt. 闩住, 发射, 脱口而出, 筛, 囫囵吞下 vi. 囫囵吞枣, 射箭, 脱缰, 退出党派 adv. 突然
bond	n. 捆绑物, 结合, 债券, 契约, 粘合剂, 保证人, 键, 关栈保留 vt. 存入关栈, 使黏合 vi. 结合
bones	n. 骨骼, 尸体
bonus	n. 奖金, 红利 [经] 奖金, 红利, 额外补贴
book	n. 书, 书籍, 帐簿, 名册, 工作簿 v. 登记, 预订 [计] 工作簿
bookcase	n. 书架, 书柜
booking	n. 预约演出合同 [机] 书型模法
bookkeeper	n. 簿记员 [经] 簿记员, 记帐员
booklet	n. 小册子
booklist	(某个题目或学科的)推荐书目, 书单
books	n. 书评；书籍（book的复数）
bookshelf	n. 书架
bookshop	n. 书店
boom	n. 繁荣, 隆隆声 vi. 急速发展, 发隆隆声 vt. 使兴旺, 发隆隆声
boost	n. 推进, 吹捧 vt. 推进, 提高, 宣扬, 促进
boot	n. 长靴, 踢, 解雇, 效用 vt. 使穿靴, 踢, 解雇, 有用 [计] 引导, 自举
booth	n. 亭, 摊棚 [经] 货摊, 电话间
boots	n. （英）擦靴的仆役；靴子（boot的复数）
border	n. 边缘, 边境, 边界, 花坛 vt. 在...上镶边, 接近 vi. 接界, 近似 [计] 边框
bore	n. 令人讨厌的人, 激浪, 枪膛, 孔 vt. 使烦扰, 钻孔 vi. 钻孔 bear的过去式 [计] 内径; 孔径
bother	vt. 烦扰, 迷惑 vi. 烦恼, 操心 n. 麻烦, 纠纷, 讨厌的人
bounce	n. 跳, 跳跃, 弹力, 撞击 vi. 反跳, 弹跳 vt. 使跳回, 撞击 [计] 打回
bound	n. 跃, 回跳, 范围, 边界 a. 受约束的, 装有封面的, 有义务的, 关联的, 被束缚的, 准备去...的, 便秘的 vi. 跳跃, 弹起 vt. 使跳, 限制, 形成...的疆界 bind过去式和过去分词 [计] 装订的
boundary	n. 边界, 分界线 [计] 边界
bounty	n. 慷慨, 宽大, 礼物 [经] 奖励金, 补贴
bouquet	n. 花束 [医] 丛, 酒香, 末梢分极
bowel	n. 肠, 内脏, 内部 vt. 挖...的内脏
bowling	n. 保龄球戏
bowls	n. 滚木球戏
boycott	n. 联合抵制 vt. 联合抵制
brace	n. 支柱, 曲柄, 支撑, 一对 vt. 紧缚, 支撑, 激励 vi. 打起精神 [计] 花括号
bracket	n. 支架, 括弧, 托架 vt. 装托架, 括入括弧 [计] 方括号; 括号
brake	n. 刹车, 阻碍, 丛林 v. 刹车
branch	n. 树枝, 支店, 支流, 分部 vi. 分支, 出枝 vt. 分割, 用枝状叶脉刺绣花纹装饰 [计] 分支, 目录分支
brand	n. 商标, 牌子, 烙印 vt. 打烙印于
breach	n. 裂口, 违背, 破坏, 违反, 突破, 破裂 vt. 攻破, 突破 vi. 跳出水面
break	n. 休息, 中断, 破裂处, 绝交, 破晓, 突变 vt. 打破, 弄破, 弄坏, 破坏, 违反, 打断, 削弱, 放弃 vi. 破碎, 决裂, 破晓, 突变, 变弱, 暂停 n. 分隔符 [计] 分隔符; 中断; DOS内部命令:设定扫描中断按键的时机
breakdown	n. 崩溃, 故障 [化] 事故; 击穿
breakfast	n. 早餐
breakthrough	n. 突破 [经] 突破, 新发现, 新进展
breed	n. 种类, 品种 v. 养育, 引起, 饲养, 繁殖
breeding	n. 教养, 生育, 饲养 [医] 生育, 繁殖, 育种, 饲养
breeze	n. 微风, 煤屑, 轻而易举的事 vi. 吹微风, 逃走
brew	n. 酿造酒, 酝酿 v. 酿造, 酝酿
bribe	n. 贿赂 vt. 贿赂, 收买 vi. 行贿
bridge	n. 桥, 舰桥, 桥梁, 桥牌 vt. 架桥于, 跨越 [计] 桥, 网桥, 桥接器
briefcase	n. 公事包
brilliant	a. 光辉的, 灿烂的, 有才气的 [机] 亮的
bring	vt. 带来, 产生, 促使, 提出 vi. 生产
bring about	带来, 使掉头
brink	n. 边缘, 陡岸
brisk	a. 强烈的, 寒冷而干燥的, 活泼的 vt. 使活泼 vi. 活跃起来
Bristol	n. 布里斯托尔(英国西部港口)
Britain	n. 英国
British	a. 英国的 n. 英国人, 英国英语
brittle	a. 易碎的, 脆弱的, 易坏的 [机] 脆的, 脆性的, 易碎的
brochure	n. 小册子, 小册
brochures	n. 小册子( brochure的名词复数 ); （某地、某旅馆等的）情况介绍手册; （印成小册子的）论文
bronze	n. 青铜, 铜像 a. 青铜色的
brood	n. 一窝, 一伙 vt. 孵, 沉思
brothers	n. 哥们儿, 兄弟
browse	v. 浏览, 吃草 n. 浏览, 吃草 [计] 浏览
bruise	n. 青肿, 挫伤, 擦伤 vi. 受伤, 擦伤 vt. 使受伤, 研碎
brutal	a. 残忍的, 野蛮的, 不讲理的
bubble	n. 泡沫 vi. 冒泡, 沸腾 vt. 使冒泡, 滔滔不绝地说
buck	n. 元, 雄鹿, 纨绔子弟, 鞍马, 培克(赌博时的庄家标志), 碱水, 自夸, 谈话 vi. 马背突然拱起, 反对, 吹牛, 闲聊 vt. 马背突然拱起将骑手摔下, 反对, 用碱水洗 a. 雄的
bucket	n. 桶 [计] 存储桶; 桶
buckle	n. 皮带扣, 扣子 vt. 扣住, 使弯曲 vi. 扣住, 变弯曲, 屈服
bud	n. 芽, 花蕾 vi. 发芽, 萌芽 vt. 使发芽
budget	n. 预算 vi. 编预算 vt. 编入预算, 安排 a. 廉价的
buffet	n. 自助餐, 小卖部, 碗橱, 殴打, 冲击 vt. 连续打, 冲击, 搏斗 vi. 奋斗
bug	n. 错误, 虫, 病菌, 缺陷, 窃听器, 癖好, 防盗报警器, 双座小汽车, 要人 vt. 装防盗报警器, 装窃听器, 激怒 vi. 捉虫, 暴突 [计] 缺点, 错误
building	n. 建筑物, 建筑 [法] 营造, 建筑, 建筑物
buildings	n. 建筑物（building的复数）
bulb	n. 球茎, 电灯泡 [医] 球, 鳞茎, 球茎
bulge	n. 胀, 膨胀 vi. 凸出 vt. 使膨胀
bulk	n. 大小, 体积, 大块, 大多数 vt. 显得大, 显得重要
bull	n. 公牛 [法] 买方, 买空者
bulletin	n. 公告, 布告, 公报 [电] 电子布告栏
bully	n. 欺凌弱小者, 土霸 vt. 威胁, 恐吓, 欺负 vi. 欺负 a. 特好的, 第一流的 adv. 十分
bump	n. 撞击, 肿块 vt. 碰撞 vi. 撞, 颠簸而行
bumper	n. 缓冲器, 满杯 a. 大胜利的
bunch	n. 串, 束 [医] 骨肿块(马)
bundle	n. 捆, 束 vt. 包扎, 胡乱塞进 vi. 匆忙离开
bungalow	n. 平房
bunk	n. 铺位, 废话, 逃走 vi. 逃跑, 睡在铺上 vt. 提供铺位
buoyant	a. 有浮力的, 心情愉快的 [经] 降而复升的, 保持高价的, 遂之而升的
bureaucracy	n. 官僚, 官吏 [法] 官僚主义, 官僚政治, 官僚机构
burgeon	n. 芽, 嫩枝 v. 萌芽, 发芽
burger	n. 汉堡包（等于hamburger）
burglar	n. 窃贼 [法] 夜盗, 窃贼, 盗窃者
burial	n. 埋葬, 葬礼 [法] 埋葬, 葬礼
burrow	n. 洞穴, 藏身处 vi. 掘洞穴, 躲藏 vt. 掘, 打洞
bus	n. 公共汽车 [计] 总线; 汇流条; 母线
business	n. 生意, 事情, 业务, 商业, 商行, 职责 [经] 企业, 商业, 营业
bust	n. 半身像, 胸部, 失败, 殴打 vt. 使爆裂, 使破产 vi. 爆裂, 破产 [计] 操作错
bustle	n. 喧闹, 裙撑 vi. 奔忙, 喧闹 vt. 使忙碌, 催促
butcher	n. 屠夫, 肉商, 小贩 vt. 屠宰, 屠杀
butterfly	n. 蝴蝶 [医] 蝶式棉块, 翼形皮癣, 纸蝶
buzz	n. 嗡嗡声, 流言 vi. 发出嗡嗡声, 说闲话 vt. 使嗡嗡叫, 散布
bypass	n. 旁路 vt. 省略, 绕过, 忽视, 回避
cab	n. 出租车, 出租汽车, 出租马车 vi. 乘出租马车(或汽车)
cabin	n. 小屋, 客舱 vt. 关在小屋
cabinet	n. 橱柜, 内阁 a. 内阁的, 细木工做的 [计] 机柜
cable	n. 电缆, 海底电报, 缆, 索 vi. 打海底电报 vt. 发海底电报, 缚住 [计] 电缆
cafe	n. 咖啡馆, 酒店
cafeteria	n. 自助餐厅 [经] 自助餐厅
cages	n. 笼子( cage的名词复数 )
calamity	n. 灾难, 不幸事件
calcium	n. 钙 [化] 钙Ca
calendar	n. 日历, 日程表 vt. 列入表中 [计] 日历
call	n. 呼叫, 访问, 打电话, 号召, 召集, 要求 vt. 呼叫, 召集, 打电话 vi. 叫喊, 访问, 叫牌 [计] 调用; 呼叫; DOS内部命令:在批处理文件中调用另一个批处理文件
calorie	n. 卡路里（热量单位）
Cambridge	n. 剑桥
camera	n. 照相机, 摄影机, 密谈室, 暗箱 [计] 摄影
camp	n. 露营, 帐篷 vi. 露营, 扎营 vt. 使扎营
campaign	n. 战役, 运动, 竞选运动 vi. 参加运动, 作战
campus	n. 校园, 大学生活
Canadian	a. 加拿大的
canal	n. 运河, 水道, 管, 沟渠 vt. 开运河
cancel	n. 取消, 撤消, 盖销(邮票) vt. 取消, 删去, 抵销, 盖销 vi. 相互抵销 [计] 作废
candidate	n. 候选人, 投考者 [法] 候选, 候补者
candle	n. 蜡烛 vt. 对着光检查
candles	n. 蜡烛, 烛台（candle复数形式）
cane	n. 手杖, 细长的茎, 藤条 vt. 以杖击, 以藤编制
cannon	n. 大炮, 加农炮 v. 炮轰
canteen	n. 水壶, 军中俱乐部, 临时流动餐馆, 小卖部
canvas	n. 帆布, 画布, 油画 [化] 帆布
capacity	n. 容量, 能力, 才能, 资格 [计] 容量
cape	n. 岬, 海角, 披肩, 斗蓬
capital	n. 首都, 大写字母, 资本 a. 首都的, 重要的
capsule	n. 胶囊, 蒴果, 瓶帽, 航天舱 [化] 胶囊剂
caption	n. 说明, 字幕, 标题 vt. 加上标题, 加上说明 [计] 标题
captive	n. 俘虏, 迷恋者 a. 被俘的, 被迷住的
capture	n. 抓取, 战利品, 捕获之物 vt. 抓取, 获得, 迷住 [计] 截获命令
carbon	n. 碳, 副本, 复写纸 [化] 碳
carcase	n. 尸体, 架子
card	n. 卡片, 纸牌, 节目单, 明信片, 梳棉机 vt. 备置卡片, 记于卡片上, 梳理 [计] 卡片, 卡
cardinal	n. 红衣主教, 鲜红色 a. 主要的, 深红色的
cards	n. (playing cards)(正式)一副纸牌, 一副扑克牌, 纸牌游戏, 打扑克
care	n. 小心, 照料, 忧虑 vi. 关心, 介意 vt. 在意, 喜欢
career	n. 事业, 生涯, 成功 [法] 职业, 专业, 履历
carpenter	n. 木匠
carpet	n. 地毯, 地毯状物 vt. 铺以地毯, 铺盖
carrier	n. 运送者, 邮递员, 带菌者 [计] 载波
carrot	n. 胡萝卜 [医] 胡萝卜
carry	n. 进位, 射程, 运载 vt. 携带, 运送, 支持, 传送, 包含 vi. 被携带, 能达到 [计] 进位; 进位数
cart	n. 二轮运货马车 vi. 驾运货马车 vt. 用车装载
carton	n. 硬纸盒, 纸板箱 [化] 卡纸
cartoon	n. 卡通画, 漫画 v. 画漫画
carve	v. 雕刻, 切开
carving	n. 雕刻品, 雕刻, 雕刻术
case	n. 情形, 情况, 箱, 容器, 事实, 病例, 案例, 框子 vt. 装箱, 包盖
cash	n. 现金 vt. 兑现
cashier	n. 出纳员 [经] 司库, 出纳员, 收支员
cassette	n. 盒式磁带, 珠宝箱, 暗盒 [计] 字盒
cast	n. 演员阵容, 投掷, 铸件, 预测, 特性 vt. 投, 掷, 抛, 脱落, 铸, 使弯曲, 计算 vi. 投, 计算, 浇铸成型
castle	n. 城堡, 象棋中的车 vt. 置于城堡中, 盘踞于
casual	a. 偶然的, 不经意的, 便装的 n. 临时工, 待命士兵
casualty	n. 意外事故, 伤亡, 受害者 [化] 事故
catalog	n. 目录, 大学概况手册 vt. 编目录 [计] 目录; 编目
catalogue	n. 目录, 大学情况一览 vt. 编入目录
catalyst	n. 触媒, 接触剂, 催化剂, 刺激因素, 促进因素 [计] 催化剂
catastrophe	n. 大灾难, 大祸 [化] 突变
catch	n. 捕捉, 陷阱, 捕捉之物, 抓, 拉手 vt. 捕捉, 赶上, 感染, 听清楚 vi. 抓住, 燃着
catching	a. 易传染的, 有魅力的, 吸引人的
category	n. 种类, 类项 [计] 分类
cater	v. 提供饮食及服务, 投合, 迎合
catering	n. 给养；承办酒席；[医]提供饮食及服务
cathedral	n. 大教堂
catholic	n. 天主教徒 a. 天主教的, 普遍的, 广泛的, 宽宏大量的
cattle	n. 牛, 家畜 [法] 家畜
cause	n. 原因, 目标 vt. 引起, 使产生, 使遭受
causes	n. 原因
caustic	n. 腐蚀剂 a. 腐蚀性的
caution	n. 小心, 慎重, 警示 vt. 警告 [计] 警告
cautious	a. 谨慎的, 小心的
cave	n. 洞, 穴 vi. 凹陷, 塌落 vt. 挖洞, 使凹陷, 损坏...的基础
caves	n. 咖啡馆, 小餐厅( cafe的名词复数 ); 洞穴( cave的名词复数 )
cavity	n. 洞, 空穴, 腔 [化] 空穴
CD	n. 镭射碟, 镭射唱片 [计] 光盘, 压缩盘, 载波检测, DOS内部命令:显示或改变当前目录
CD-ROM	n. 光盘驱动器
cease	n. 停止 v. 停止, 终了
cellar	n. 地窖, 地下室, 藏酒
cement	n. 水泥, 胶结剂 vt. 胶合, 用水泥涂 vi. 黏牢
cemetery	n. 墓地, 公墓 [法] 公墓, 墓地
censor	n. 检查员 vt. 检查, 审查, 删改
census	n. 户口普查 vt. 实施统计调查
centenary	n. 一百年 a. 一百年的
center	n. 中心, 中心点, 中锋 a. 中央的, 位在正中的 vt. 集中, 定中心 vi. 居中 [计] 居中; 中央
central	a. 中央的, 重要的 [医] 中央的, 中心的, 中枢的
centre	n. 中心, 中心点, 中锋 a. 中央的, 位在正中的 vt. 集中, 定中心 vi. 居中
century	n. 世纪, 百年
ceramic	a. 陶瓷的 n. 陶瓷制品
cereal	n. 谷类食品, 谷类植物 a. 谷类的
ceremony	n. 典礼, 仪式, 礼节 [法] 典礼, 仪式
certainty	n. 确定, 确实的事情 [法] 确定, 肯定, 必然的事
certificate	n. 证书, 证明书 vt. 发给证明书, 用证书批准, 用证书证明
certificates	n. 证明书, 执照( certificate的名词复数 )
certify	v. 证明, 保证
chair	n. 椅子, 显要的席位, 主席 vt. 使入座, 使就任要职
challenge	n. 挑战, 盘问 vt. 向...挑战, 要求, 怀疑 vi. 挑战, 对(证据等)表示异议
challenging	a. 挑战的, 引起争论的
chamber	n. 室, 房间, 枪膛 vt. 装(弹药), 把...关在室内 a. 室内的
champagne	n. 香槟酒, 香槟酒色 [化] 香槟酒
champion	n. 冠军, 拥护者, 战士 vt. 保卫, 拥护 a. 优胜的
chance	n. 机会, 意外, 可能性 vi. 偶然发生 vt. 冒险
chancellor	n. 大臣, 总理, 首相, 大使馆/领事馆的一等秘书, 司法官, 大学校长
channel	n. 海峡, 航道, 频道 vt. 引导, 在...上挖沟, 形成河道 [计] 信道, 通道
chant	n. 圣歌, 赞美诗 v. 吟唱, 诵扬
chaos	n. 大混乱, 混沌 [化] 混沌; 浑沌
chapel	n. 小教堂, 礼拜式
chapter	n. 章, 篇, 重要章节 [计] 章; 段
characteristic	n. 特性, 特征, 特色 a. 特性的, 特有的, 有特色的 [计] 阶; 指数
characterize	vt. 描绘...的特性, 刻划...的性格
charge	n. 指控, 费用, 冲锋, 电荷, 炸药, 主管, 被托管人, 命令 vt. 控诉, 加罪于, 使充满, 使充电, 使承担 vi. 冲锋, 要价, 收费
charges	n. 费用；手续费；运费
charity	n. 慈悲, 博爱, 慈善团体, 施舍 [法] 宽大, 宽恕, 慈善机关
charm	n. 吸引力, 魔力, 符咒 vt. 迷住, 使陶醉, 行魔法 vi. 用符咒, 有魅力
chart	n. 图表, 海图 vt. 制成图表 [计] 图表
charter	n. 特许状, 执照, 宪章 vt. 特许, 发给特许执照
chase	n. 追求, 狩猎, 追逐 vt. 追捕, 追逐, 雕刻, 在...上镶嵌宝石 vi. 追赶, 奔跑
chasm	n. 陷窟, 裂口
chaste	a. 贞洁的, 纯洁的, 朴素的
chat	n. 闲谈 vi. 闲谈, 聊天
cheaper	a. 成本更低, 比较便宜的
check	n. 检查, 支票, 阻止物, 寄物牌, 象棋中将军 vt. 检查, 阻止, 核对, 寄存, 托运 vi. 逐项相符, 开支票 [计] 复选
checks	n. 支票；格（check的复数形式）
checkup	n. 审查, 鉴定, 健康检查
cheer	n. 愉快, 振奋, 欢呼 vi. 欢呼, 喝彩, 快活起来 vt. 使振奋, 欢呼
cheerful	a. 快活的, 高兴的, 兴高采烈的
cheese	n. 乳酪 [化] 干酪
chemist	n. 化学家, 药剂师 [化] 化学家; 化学师; 化学工作者; 药剂师; 药房
chemistry	n. 化学, 化学过程 [化] 化学
cherish	vt. 珍爱, 怀有, 爱护
chest	n. 胸, 胸部, 衣柜, 箱子 [医] 胸, 胸廓
chew	vt. 咀嚼, 嚼碎 vi. 咀嚼, 细想 n. 咀嚼, 咀嚼物
chic	n. 漂亮, 别致的款式 a. 漂亮的, 别致的
chicks	n. 雏鸡；小鸡（chick的复数形式）
chief	n. 领袖, 酋长, 长官, 主要部分 a. 主要的, 首位的
child	n. 孩子, 产物, 追随者 [医] 儿童
childcare	n. 儿童照管；儿童保育
children	pl. 孩子, 孩子们
chill	n. 寒冷, 寒意, 失意 a. 寒冷的, 冷漠的 vt. 使寒心, 冷冻 vi. 变冷
chin	n. 下巴, 颏 [医] 颏
Chinese	n. 中文, 中国话, 中国人 a. 中国的, 中国话的
chip	n. 屑片, 薄片, 碎片 vt. 削, 切, 削成碎片, 使摔倒, 凿 vi. 削下屑片 [计] 孔屑; 组件; 晶片; 芯片
chisel	n. 凿子 v. 凿, 刻, 雕凿, 欺骗
chocolate	n. 巧克力 a. 巧克力制的
choice	n. 选择, 精选品, 选择权 a. 精选的, 挑三拣四的, 上等的 [计] DOS内部命令:在批处理文件中 该命令用于提示用户作出选择, 决定批处理文件的流程
choices	n. 选择（choice的复数）
choir	n. 唱诗班, 唱诗班的席位 v. 合唱
choke	vt. 窒息, 阻塞, 噎, 抑制 vi. 窒息, 阻塞, 噎 n. 窒息, 噎, 阻气门
chop	n. 肋条肉, 排骨, 砍, 戳记, 商标 vt. 剁碎, 砍, 切击, 割断 vi. 砍, 突然转向
chord	n. 弦, 和音 [医] 索, 带
chore	n. 零工, 家务 [经] 零工
chorus	n. 合唱队, 齐声 v. 齐声说道, 合唱
Christian	n. 基督徒, 正派人 a. 基督的, 基督教的
chronic	a. 慢性的, 习惯性的 n. 慢性病患者
chronological	a. 年代学的, 按时间顺序的, 按照年月顺序的 [计] 编年的, 按年月日顺序的
chunk	n. 大块, 矮胖的人(或物) [经] 定样
church	n. 教堂, 礼拜, 教会 vt. 使人接受宗教仪式 a. 教堂的
cinema	n. 电影院, 电影
circle	n. 圆周, 社交圈, 循环, 范围 vt. 围着, 环绕 vi. 盘旋, 循环
circuit	n. 电路, 环(行)道, 巡回 [计] 线路; 电路
circulate	v. (使)流通, (使)循环, (使)传播
circumference	n. 圆周, 周缘, 胸围 [医] 周缘, 环状面
circumstance	n. 环境, 状况, 事件
circus	n. 马戏团, 马戏, 竞技场
cite	vt. 引用, 引证, 表彰 [建] 引证, 指引
cities	n. 城市（city的复数）
city	n. 城市, 市 [法] 都市, 城市, 市
civic	a. 市的, 市民的, 公民的 [法] 公民的, 市民的, 公民资格的
civilian	n. 平民, 民法专家 a. 平民的, 百姓的, 民用的
claim	n. 要求, 要求权, 断言, 权利 vt. 要求, 认领, 主张 vi. 提出要求, 主张, 断言
clamp	n. 夹钳 vt. 夹紧, 强加
clan	n. 氏族, 宗族, 集团 [医] 支
clarify	vi. 澄清, 阐明 vt. 使明晰
clarity	n. 清楚, 明晰 [化] 透明度; 透明性; 清晰性
clash	n. 冲突, 撞击声, 抵触 vi. 冲突, 抵触 vt. 使发出撞击声 [计] 对撞
clasp	n. 扣子, 钩, 紧握 v. 扣紧, 紧握
class	n. 班级, 阶级, 种类, 课 vt. 分类 [计] 类别; 类; 种类; 类程
classic	n. 古典作品, 杰作, 大艺术家 a. 第一流的, 最优秀的, 古典的
classical	a. 古典的, 正统派的, 经典的 [医] 古典的; 标准的, 典型的
classify	vt. 分类, 归类, 分等 [建] 分类, 分级, 分粒
classmates	n. （同班）同学( classmate的名词复数 ); 砚兄砚弟
classroom	n. 教室
clause	n. 子句, 条款 [计] 子句
clean	a. 干净的, 清白的, 简洁的 adv. 清洁地, 完全地 vt. 清理, 使干净, 出空 vi. 被搞干净 n. 打扫
cleaner	n. 清洁工人, 清洁剂, 干洗商 [化] 滤清器; 除垢器; 洗净剂; 清洁剂
cleaning	n. 清洁, 扫除, 家畜的胞衣, 扫除出来的垃圾, 大败, 输得精光, 除伐, 巨额利润 [计] 清洗, 清除
clear	a. 清楚的, 明确的, 澄清的 adv. 清晰地 vt. 澄清, 清除障碍 vi. 放晴, 变清澈 n. 空隙 [计] 清除
clearance	n. 清除, 间隙 [化] 间隙; 空隙
clever	a. 聪明的, 精明的
cliche	n. 陈腔滥调, 凸印版 a. 陈腐的
click	n. 咔哒声, 啪嗒声 vi. 作咔哒声 vt. 使发咔哒声 [计] 单击
client	n. 客户, 顾客, 委托人 [计] 客户, 客户机, 客户机程序
clients	n. 客户端；顾客；救济对象；应受账款；委托方（client的复数）
cliff	n. 悬崖, 绝壁
climax	n. 高潮, 极点, 层进法 v. (使)达到顶点, (使)达到高潮
cling	vi. 粘紧, 附着, 紧贴, 坚持
clinic	n. 诊所, 临床教学 [医] 诊所(门诊部); 临床(讲解); 临床(学)科
clip	n. 修剪, 夹子, 回形针, 剪下来的东西 vt. 修剪, 痛打, 夹牢, 剪报 vi. 剪报
clock	n. 时钟, 计时器, (袜子上的)绣花边花 vt. 绣花样, 记时, 记录 vi. 记录时间 [计] 时钟
clockwise	a. 顺时针方向的 adv. 顺时针方向地
close-up	n. 特写镜头, 仔细的观察, 小传 [化] 闭合; 接通
closet	n. 壁橱, 小室 a. 秘密的, 空谈的 vt. 把...关入小室
cloth	n. 布料, 织品, 布 [建] 布
clothes	n. 衣服
clothing	n. 衣服
club	n. 俱乐部, 木棍, 球棒 vt. 用棍棒打, 缴纳 vi. 联合起来 a. 俱乐部的
clubs	n. （扑克牌）梅花；俱乐部；社团（club的复数）
clue	n. 线索, 暗示 vt. 暗示, 提供线索
clumsy	a. 笨拙的, 不雅观的, 粗陋的
cluster	n. 串, 丛, 群, 簇 vi. 成串, 丛生 vt. 使聚集 [计] 簇
clutch	n. 抓紧, 掌握, 离合器, 一窝小鸡 vt. 抓住, 踩汽车离合器踏板 vi. 抓 [计] 联轴器; 离合器
co-operation	n. 合作
co-operative	a. 合作的；有协作精神的；愿意配合的; 齐心协力的；合作进行的 n. 合作社；合作机构
coach	n. 四轮大马车, 教练 vt. 训练, 指导 vi. 坐马车旅行, 作指导
coalition	n. 结合体, 结合, 联合 [经] 联合, 联盟
coarse	a. 粗糙的, 下等的, 粗俗的 [计] 粗略的
coastal	a. 海岸的, 沿海的, 沿岸的 [法] 海岸的, 沿海的
cocaine	n. 可卡因, 古柯碱 [化] 可卡因; 古柯碱
cocktail	n. 鸡尾酒, 开味品 a. 鸡尾酒会的
code	n. 代码, 密码, 法规, 法典 vt. 把...编码 [计] 代码
coeducation	n. 男女同校
coerce	vt. 强制, 强迫
coffee	n. 咖啡, 咖啡色 [医] 咖啡, 咖啡豆
cognitive	a. 认知的, 认识的
coherent	a. 互相耦合的, 清晰的, 明了的，凝聚性的, 连贯的
coil	n. 线圈, 盘绕, 骚动, 卷 vt. 盘绕, 卷
coin	n. 硬币, 金钱, 货币 vt. 铸币, 创造, 杜撰
coincide	vi. 一致, 符合 [化] 重合
coincidence	n. 巧合, 同时发生 [电] 符合计数器
cola	结肠, 冒号, 科朗 [化] 可乐果; 可乐果属; 可乐果干子叶
collaboration	n. 合作, 勾结 [法] 通敌卖国者, 奸细
collapse	n. 崩溃, 倒塌, 虚脱 vi. 倒塌, 崩溃, 瓦解 vt. 使倒塌, 折叠 [计] 折叠
colleagues	n. 同事；同行（colleague的复数）
collection	n. 收集, 采集, (一批)收藏品, 募捐 [医] 收集; 收集品, 标本
college	n. 学院, 大学, 学会
colleges	n. 专科学院（college复数形式）
collide	vi. 碰撞, 互撞, 抵触
collision	n. 碰撞, 冲突, 抵触 [计] 冲突
colonial	a. 殖民的, 殖民地的 [法] 殖民地居民
colony	n. 殖民地, 移民队 [医] 菌(集)落, 菌丛; 移民区
color	n. 颜色, 面色, 颜料, 外貌 vt. 把...涂上颜色, 粉饰, 使脸红, 歪曲 vi. 变色
colossal	a. 巨大的, 巨像似的
column	n. 专栏, 圆柱, 纵队, 列, 柱形物 [计] 列, 柱形图
combat	n. 争斗, 战斗 vi. 战斗, 争斗 vt. 与...战斗, 与...斗争
combine	v. (使)联合, (使)结合 n. (企业的)联合, 联合收割机
combustible	a. 易燃的, 燃烧性的, 易动激情的 n. 易燃物, 可燃物
come	vi. 过来, 来, 到达, 出现, 开始 interj. 喂
comedy	n. 喜剧, 有趣的事情
comet	n. 彗星
comfortable	a. 舒服的, 轻松的 n. 盖被
comic	n. 连环漫画, 喜剧演员, 滑稽的人 a. 滑稽的, 有趣的, 喜剧的
commemorate	vt. 纪念
commence	v. (使)开始, 得学位
commend	vt. 嘉奖, 委托给, 推荐
comment	n. 注解, 批评, 评论, 备注 vi. 评论, 注解 [计] 备注
commentary	n. 注释, 评论, 说明 [法] 注释, 评注, 评论
commercial	a. 商业的, 商用的, 商品化的 n. 商业广告节目
commercials	n. （电台或电视播放的）广告 ( commercial的名词复数 ); 以大众欣赏为目的谱写的乐曲
commission	n. 委任状, 任官令, 所委职责, 佣金, 犯, 委托, 所托之事 vt. 委任, 委托制作, 使服役
commit	vt. 委托(托付), 犯罪, 指派...作战, 使承担义务 [法] 犯, 做, 把...交托给
commitment	n. 委托, 交押, 承担义务, 赞助 [医] 院禁
committee	n. 委员会 [经] 委员会
commodity	n. 农产品, 商品, 有用的物品 [经] 商品, 货物, 日用品
common	a. 通常的, 共同的, 通俗的, 公共的 [计] 公用块
commonplace	n. 寻常事, 老生常谈, 普通的东西 a. 平凡的, 普通的
commonwealth	n. 共和国；联邦；国民整体
commotion	n. 骚动, 暴乱 [医] 震荡
communication	n. 交流, 交通, 通讯 [计] 通信
community	n. 社区, 公众, 共有, 共同体 [经] 公众, 共有, 社会
commute	vt. 交换, 折偿, 减轻 vi. 代偿, 经常乘车来往
commuter	n. 乘公共车辆上下班者, 月季票乘客 [经] 非(当地)居民
compact	a. 紧凑的, 紧密的, 简洁的 vt. 使紧密结合, 压缩 vi. 变坚实
companies	n. 公司, 企业；公司财产；伙伴（company的复数形式）
companion	n. 朋友, 陪伴, 指南, 升降口围罩 vt. 陪伴
company	n. 公司, 友伴, 交往, 连队, 朋友, 一群 vt. 陪伴 vi. 交往
comparable	a. 可比较的, 比得上的
compare	vt. 比较, 比喻, 对照 vi. 相比 n. 比较 [计] 比较
compartment	n. 分隔间, 卧车包房, 防水舱隔 [医] 隔室, 隔间
compass	n. 指南针, 范围, 音域 vt. 包围, 达到, 图谋, 理解
compatible	a. 能共处的, 可并立的, 适合的 [计] 相容的; 兼容的
compel	vt. 强迫, 迫使
compensate	v. 偿还, 补偿, 付报酬
compensation	n. 补偿, 赔偿金, 工资 [医] 代偿(机能), 补偿
competence	n. 胜任, 职称, 能力 [医] 能力, 活性
competition	n. 竞争, 竞赛 [经] 竞争, 竞销, 比赛
competitive	a. 竞争的 [经] 竞争的
compile	vt. 编译, 编辑, 编纂, 收集 [计] 编译
complaint	n. 诉苦, 抱怨, 控诉 [医] 陈诉; 病
complement	n. 补足物, 补语, 补数 vt. 补充, 补足 [计] 补码; 反相器; 补数
complete	a. 完全的, 十足的, 完成的 vt. 完成, 完工, 使圆满
complex	n. 综合体, 情结, 络合物 a. 复杂的, 组合的
complexion	n. 肤色, 情况, 局面 [医] 体质; 面色, 面容
compliance	n. 遵从, 顺从, 屈从 [化] 柔顺; 顺应
complicated	a. 复杂的 [医] 并发的
complication	n. 复杂化, 复杂情况 [医] 并发症, 并发病
compliment	n. 称赞, 恭维, 敬意 vt. 称赞, 褒扬, 恭维
comply	vi. 顺从, 依从 [法] 遵守, 承诺, 照做
component	n. 元件, 组件, 成分 a. 组成的, 构成的 [计] 组件
compose	vt. 组成, 写作, 作曲, 使平静 vi. 创作, 排字 [计] 编写
composite	a. 合成的, 混合成的, 菊科的 n. 合成物, 复合材料, 菊科
composition	n. 作文, 创作, 组成 [化] 成分; 组成
compound	n. 混合物, 复合词, 化合物, 院子 a. 复合的, 混合的, 化合的 vi. 化合, 和解, 妥协 vt. 使复合, 使化合
compress	vt. 压缩, 压紧 vi. 受压缩小 [计] 压缩程序
comprise	vt. 包含, 构成
compromise	n. 妥协, 折中, 折中方案, 和解 vi. 妥协处理 vt. 危害
compulsory	a. 被强制的, 强迫的, 义务的 [经] 强迫的, 强制的
compute	v. 计算, 估算 n. 计算, 估算
computer	n. 电脑, 电子计算机 [计] 计算机
computers	n. 计算机, 电脑（computer的复数）
conceal	vt. 隐藏, 掩盖, 隐瞒 [法] 隐瞒, 隐匿, 保守秘密
concede	vt. 承认, 退让 vi. 让步
conceive	vt. 构思, 认为 vi. 怀孕
concentrate	n. 浓缩, 精选 v. 集中, 专心
conception	n. 观念, 概念 [医] 妊娠, 受孕; 概念
concern	n. 关心, 忧虑 vt. 与...有关, 使担心, 使挂念
concert	n. 音乐会, 和声, 一致 vt. 协力, 协调 vi. 协力 [计] 美国北卡罗来纳州Internet网
concerted	a. 商定的, 协定的, 一致的 [法] 一致的, 协力的, 共同的
concession	n. 特许, 让步, 认可 [经] 核准, 许可, 特殊(权)
concessions	n. （尤指由政府或雇主给予的）特许权( concession的名词复数 ); 承认; 减价; （在某地的）特许经营权
concise	a. 简洁的, 简明的
conclusion	n. 结论, 结尾, 推论 [法] 缔结, 结论, 推论
concoct	vt. 调合, 捏造, 编造 [建] 调制, 混合
concrete	n. 凝结物, 混凝土 a. 具体的, 实在的, 混凝土的 v. (使)凝结, 用混凝土浇筑
condemn	vt. 判刑, 责备, 谴责 [法] 定罪, 判刑, 宣告有罪
condense	vt. 使浓缩, 使压缩, 缩短 vi. 浓缩, 凝结
condition	n. 情况, 条件 vt. 使健康, 以...为条件, 决定, 使适应 [计] 条件
conditions	n. 形势, 情况, 环境
condolence	n. 哀悼, 吊唁
conducive	a. 有益于...的, 有助于...的, 助长的
confer	vt. 授予, 带来 vi. 协商
conference	n. 会议 [经] 会议, 讨论会, 协商会
confess	v. 承认, 坦白, 忏悔, 供认
confidence	n. 信心 [电] 可靠
confident	a. 有信心的, 有把握的
confidential	a. 机密的, 获他人信赖的, 易于信任他人的 [经] 秘密件
configuration	n. 结构, 表面配置, 外形, 配置 [计] 配置
confine	vt. 限制, 使不外出, 禁闭 vi. 邻接, 交界 n. 边缘, 范围, 区域
confirm	vt. 证实, 确定, 批准, 使巩固 [计] 确认
confirmation	n. 证实, 证明, 批准, 确认 [计] 确认
conflict	n. 战斗, 冲突, 矛盾, 争执 vi. 争执, 战斗, 冲突, 抵触 [计] 冲突
conform	vt. 使一致, 使遵守, 使符合 vi. 一致, 符合, 适应
confront	vt. 使面对, 对抗, 遭遇, 使对质, 比较 [法] 对证, 使对质, 比较
confuse	vt. 使混乱, 使狼狈, 使困惑 [法] 混淆
confusion	n. 混乱, 混淆, 无秩序 [计] 含混
congestion	n. 拥挤, 充血 [计] 拥挤, 拥塞
congress	n. 国会, 会议, 讨论会 [医] 会议, 会合
congruent	a. 适合的, 一致的, 合谐的, 全等的
conjunction	n. 连接词, 联合, 结合 [计] 合取
conquer	vt. 克服, 征服, 战胜 vi. 得胜
conqueror	n. 征服者, 胜利者
conquest	n. 战胜, 征服, 战利品 [法] 征服, 赢得, 获得
conscience	n. 良心 [法] 良心, 道德感, 正义感
conscientious	a. 有责任心的, 负责的, 本着良心的 [法] 凭良心做的, 有道德感的
conscious	a. 有意识的, 知觉的, 觉察的 [医] 有意识的, 清醒的
consecutive	a. 连续的, 联贯的 [计] 连续的; 连接的
consensus	n. 合意, 一致, 同感 [计] 合意
consent	n. 同意, 许可 vi. 同意, 赞同
consequence	n. 结果, 重要性 [法] 结果, 后果, 推断
consequent	n. 随后发生的事情, 结果 a. 作为结果的, 合乎逻辑的
conservation	n. 保护, 保存 [医] 保存
Conservative	a. 保守的, 守旧的, 有保存力的 [化] 防腐剂; 保存剂
conservatory	a. 保存性的, 有保存力的 n. 温室, 音乐学校
conserve	n. 蜜饯, 果酱 vt. 保存, 使(能量等)守恒
considerable	a. 相当的, 可观的, 重要的
considerate	a. 体贴的, 体谅的, 考虑周到的
consign	vt. 交付, 储蓄, 委托, 寄存 [经] 托卖, 寄存, 寄销
consist	vi. 组成, 存在于, 一致
console	vt. 安慰, 藉慰 n. 控制台 [计] 控制台
consolidate	vt. 巩固, 使联合, 统一 vi. 巩固 [计] 合并计算
conspicuous	a. 显著的, 显眼的, 出众的
conspiracy	n. 同谋, 阴谋, 阴谋集团 [法] 阴谋, 通谋, 共谋
constant	n. 常数, 恒量 a. 不变的, 一定的, 时常的 [计] 常量; 常数; 恒值
constituent	n. 成分, 选民, 构成物 a. 构成的, 组织的, 选举的
constitute	vt. 构成, 组成, 任命 [建] 构造, 组成
constitution	n. 构成, 宪法, 体格 [医] 体质; 结构, 组织
constrain	vt. 强迫, 限制, 关押
constrict	vt. 压缩, 束紧, 使收缩 vi. 收缩
construction	n. 建筑, 构造, 建筑物 [化] 施工
consult	vi. 商讨, 商量, 协商, 会诊 vt. 向...请教, 查阅, 考虑
consultant	n. 顾问, 征询意见者 [医] 顾问医师
consumer	n. 消费者 [经] 消费者, 用户
consumption	n. 消费, 消费量, 痨病 [化] 消耗量; 耗量
contact	n. 联系, 交际, 熟人, 接触 vi. 接触, 联系 vt. 使接触
contacts	n. 联系人；联络方式；触体（contact的复数形式）
container	n. 容器, 集装箱 [化] 集装箱; 贮存箱; 容器(任何一种)
contaminants	n. 污染物, 致污物( contaminant的名词复数 )
contaminate	vt. 弄污, 弄脏, 污染, 毒害 [化] 污染
contemplate	vt. 注视, 沉思, 盘算 vi. 冥思苦想
contemporary	n. 同时代的人 a. 同时代的, 属于同一时期的
contempt	n. 轻视, 轻蔑 [法] 藐视, 侮辱, 轻视
contend	vi. 奋斗, 斗争, 竞争 vt. 为...斗争
content	n. 内容, 满足, 意义, 要旨 a. 满足的, 满意的 vt. 使...满足, 使...安心 [计] 内容
contention	n. 争论, 争辩, 所持的论点 [计] 争用
contents	n. 目录 [计] 目录
contest	n. 竞赛, 争论 vt. 竞争, 争取, 争辩 vi. 竞争
context	n. 上下文, 背景, 来龙去脉 n. 上下文 [计] 上下文
contingency	n. 偶然性, 可能性, 意外事故 [经] 意外事故, 意外开支, 偶然事故
continuity	n. 连续性 [化] 连续性
contract	n. 合约, 婚约, 契约 vt. 使皱缩, 使缩短, 感染, 订约, 缔结 vi. 皱缩, 订约, 收缩
contracts	n. 契约( contract的名词复数 ); 婚约; [法律]契约法; 行贿
contradict	vt. 反驳, 与...抵触, 与...矛盾 vi. 反驳
contradiction	n. 反驳, 矛盾 [法] 矛盾, 否认, 反驳
contrast	n. 差别, 对比, 对照物 vt. 使对比 vi. 成对照 [计] 反差; 对比度
contribute	vt. 有助于, 捐助, 投稿 vi. 出力, 捐献, 投稿
contribution	n. 捐助, 捐助之物, 贡献 [经] 贡献, 捐款, 补助品
contrive	v. 发明, 设计, 图谋
control	n. 控制, 管理, 克制, 控制器, 操纵装置 vt. 控制, 操纵, 抑制 [计] 控制; 控制器
controversial	a. 争论的, 论争的, 被议论的
controversy	n. 论争, 辩论, 论战, 争论 [法] 论战, 争论, 争吵
convene	vt. 集合, 召集, 召唤 vi. 聚集, 集合
convenience	n. 方便, 便利的事物, 方便的时候
convenient	a. 方便的, 合宜的 [法] 适当的, 合理而可行的, 方便的
convention	n. 大会, 协定, 惯例, 约定 [计] 约定
converge	vi. 聚合, 集中于一点 vt. 使集合
conversation	n. 会话, 说话, 交谈 [法] 交谈, 社交, 性交
conversely	adv. 相反, 逆, 颠倒, 反题, 反
conversion	n. 转变, 转换, 改变宗教信仰, 换位法 [计] 转换
convert	n. 皈依者, 改变宗教信仰者 vt. 使改变信仰, 转换, 兑换, 倒置 vi. 皈依 [计] 转换
convey	vt. 传达, 运输, 转让 [经] 转让(财产等), 搬运
convict	n. 囚犯, 罪犯 vt. 宣告有罪, 使知罪
conviction	n. 定罪, 信服, 坚信 [法] 定罪, 证明有罪, 判罪
convince	vt. 说服, 使相信 [法] 使确信, 使信服, 使人认识错误
cooking	n. 烹饪 [化] 熬炼; 热炼; 蒸煮
cooperate	vi. 合作, 协力, 配合 [化] 合作
cooperation	n. 合作, 协力, 配合 [化] 合作
coordinate	n. 同等的人(或物), 坐标 a. 同等的, 并列的 v. (使)协调
cop	n. 警官 vt. 抓住
copy	n. 副本, 摹仿, 一册 v. 复印, 抄袭, 复制 [计] 副本; 复制; DOS内部命令:复制文件 将几个文件合并成一个文件, 以及将文件传至外设或在设备之间传送
cordial	n. 兴奋剂, 补品 a. 热忱的, 诚恳的, 有兴奋作用的
cork	n. 软木塞, 软木树, 软木 [化] 木栓
corporate	a. 社团的, 合伙的, 公司的 [经] 团体的, 法人的, 社团的
corporation	n. 公司, 合作, 法人团体 [法] 法人团体, 社团, 法人
corps	n. 军, 队, 部队, 兵种 [医] 对, 团; 体, 物体
corpse	n. 尸体 [医] 尸体
correlate	n. 有相互关系的东西, 相关物 vt. 使有相互关系 vi. 相关
correspond	vi. 符合, 通信, 相当 [法] 符合, 一致, 相当
correspondence	n. 相符, 通信, 信件 [医] 对应, 相对
correspondent	n. 通讯记者, 通信者 [经] 客户, 代理商行, 代理银行
corresponding	a. 相当的, 一致的, 通信的 [计] 对应
corrode	vt. 使腐蚀, 侵蚀, 破坏 vi. 被侵蚀, 起腐蚀作用
corrupt	a. 腐败的, 贪污的, 讹误充斥的 vt. 使腐烂, 腐蚀, 使恶化 vi. 腐烂, 堕落
cosmic	a. 宇宙的, 宇宙航行的, 无限的, 有秩序的 [医] 宇宙的
cosmopolitan	a. 世界主义的, 世界性的, 全世界的, 遍生的, 不偏狭的, 卓有见识的 n. 世界主义者, 世界性
cost	n. 代价, 价值, 费用 vi. 花费 vt. 使失去, 值, 使花费
costly	a. 昂贵的, 奢华的, 费用大的
costs	n. 费用；诉讼费；损失（cost的复数）
costume	n. 装束, 服装
cosy	a. 温暖舒适的 n. 保暖套
cot	n. 行军床, 小屋, (家畜等的)棚, (家畜等的)栏 [医] 指套; 小床
cottage	n. 小屋, 茅舍
cotton	n. 棉花 vi. 和谐, 有好感, 理解
couch	n. 长沙发, 睡椅, 卧榻 vt. 横躺, 表达 vi. 躺下, 蹲伏
cough	n. 咳嗽 vi. 咳嗽 vt. 咳出
council	n. 会议, 委员会 [经] 委员会
counsel	n. 商议, 忠告, 法律顾问 v. 商议, 劝告
counter	n. 计算器, 计算者, 柜台, 筹码 a. 反方向的, 相反的 adv. 反方向地, 相反地 [计] 计数器; 计数字
counterbalance	vt. 使平均, 使平衡, 使弥补 n. 平衡量, 平衡力, 势均力敌
counterfeit	n. 赝品, 伪造品 a. 假冒的, 假装的 v. 仿造, 伪装, 假装
counterpart	n. 副本, 复本, 配对物, 相应物 [经] 副本, 正副二份中之一
countries	国家（country的复数）
country	n. 国家, 乡村, 地区, 故乡 a. 乡下的, 农村的 [计] DOS外部命令:用于设定国家代码, 包括日期时间及货币格式
countryside	n. 乡下地方, 乡下居民
coupon	n. 息票, 赠券 [经] 息票, 利息单, 联票
courier	n. 送快信的人, 伴游服务员 [法] 信使, 送急件者
course	n. 课程, 路线, 过程, 一道菜, 道路 v. 追, (使)跑
courtesy	n. 礼貌, 谦恭, 好意 [法] 优待, 礼貌, 恩惠
cover	n. 盖子, 封面, 藉口 vt. 覆盖, 掩饰, 保护, 掩护, 包括 vi. 覆盖
coverage	n. 覆盖的范围, 保险总额, 新闻报导 [化] 可达范围; 覆盖度
coward	n. 懦弱的人, 胆小的人
crack	n. 裂缝, 爆裂声 v. (使)爆裂, (使)裂开, (使)发出爆裂声 a. 第一流的 adv. 啪地一声
cradle	n. 摇篮, 发祥地, 孩提时代 vt. 放在摇篮内, 抚育 vi. 刈割
craft	n. 技艺, 手艺, 诡计 vt. 精心制作
cramming	n. 塞满, 挤满, 填鸭式教学法
crash	n. 哗啦声, 猛撞, 崩溃, 粗布 v. 撞碎, 破碎, (使)...坠毁 a. 速成的 [计] 崩溃
crater	n. 火山口, 环行山, 弹坑 [化] 焊口; 火山石; 弧坑; 焰口
crawl	n. 爬行, 匍匐而行, 养鱼池 v. 爬行
cream	n. 乳酪, 奶油, 面霜 [医] 乳油, 乳皮; 乳膏, 霜
crease	n. 皱痕, 折痕 v. (使)起皱痕
create	vt. 创造, 建造, 引起, 任命
creation	n. 创造, 创作物, 发明 [化] 产生
credentials	n. 信任状, 国书, 文件, 身份证明, 证书 [法] 信用证, 国书, 证书
credible	a. 可信的, 可靠的 [法] 可信的, 可靠的
credit	n. 信用, 信任, 荣誉, 贷款, 学分 vt. 归功于, 赞颂, 信任, 相信 [计] 信用量
creep	n. 爬, 徐行, 蠕动 vi. 爬, 蔓延, 潜行
crevice	n. 裂缝 [医] 缝
cricket	n. 蟋蟀, 板球
crime	n. 犯罪, 罪行, 罪恶 [法] 犯罪, 罪, 罪恶
criminal	n. 罪犯, 犯人, 刑事 a. 犯了罪的, 刑事的, 有罪的
cripple	n. 跛者, 残废 vt. 使跛, 使成残废, 削弱 a. 跛的, 残废的
crisis	n. 危机, 危险期, 紧要关头 [医] 危象; 骤退, 临界, 极期
crisp	a. 脆的, 新鲜的, 活泼的 v. (使)烘脆, (使)拳曲, (使)起皱 n. 松脆物
criterion	n. 标准, 准则, 规范 [化] 判据
critical	a. 批评的, 决定性的, 危险的, 临界的 [医] 危象的; 临界的, 极期的
crocodile	n. 鳄鱼
crooked	a. 弯曲的, 歪的, 邪恶的
crops	[医] 分批出现(疹)
crouch	n. 蹲伏, 蜷缩 vi. 蹲下, 蜷着, 缩着 vt. 低头
crown	n. 王冠, 王权, 顶点 vt. 使成王, 加冕, 居...之顶
crucial	a. 决定性的, 重要的, 严厉的 [医] 十字形的; 决断的, 定局的
crude	a. 天然的, 未成熟的, 粗糙的, 粗鲁的 n. 天然的物质
cruise	n. 巡航, 巡弋, 漫游 v. 巡航, 巡弋, 漫游
crumb	n. 碎屑, 面包屑, 少许 vt. 捏碎, 弄碎
crumble	v. (使)粉碎, (使)成为碎屑, 瓦解, 崩溃, 败落
crumple	vt. 弄皱, 压皱 vi. 崩溃, 变皱
crush	n. 压碎, 粉碎, 群众, 迷恋 vt. 压破, 征服, 塞, 弄皱, 榨出 vi. 被压碎, 起皱, 挤
crust	n. 外壳, 坚硬外皮, 面包皮 vt. 盖以硬皮 vi. 结硬皮
crystal	n. 水晶, 水晶装饰品, 结晶 a. 水晶的, 水晶一样的, 透明的
cube	n. 立方体, 立方 [机] 立方体, 立方
cucumber	n. 黄瓜 [医] 黄瓜, 胡瓜
cue	n. 提示, 线索 vt. 给...暗示(或提示) [计] 尾接指令
culminate	vi. 到绝顶, 达于极点, 达到高潮 vt. 使到绝顶, 使达到高潮
cultivate	vt. 培养, 耕作
cultivation	n. 教化, 培养, 耕作 [医] 培养[法]
cultural	a. 文化的, 教养的, 修养的 [医] 培养的
culture	n. 文化, 修养, 耕种 vt. 耕种, 培养
cumbersome	a. 笨重的, 麻烦的, 累赘的
cumulative	a. 累积的 [医] 蓄积的, 累积的
cunning	a. 狡猾的, 巧妙的, 可爱的 [法] 狡猾的的, 狡诈的, 熟练的
cup	n. 杯子, 茶杯, 优胜杯 vt. 使成杯状, 为...拔火罐
cupboard	n. 食橱, 碗柜, 餐具柜
cups	n. 拨火罐（器具）；杯子（cup的复数形式）
curb	n. 抑制, 勒马绳, 边石 vt. 抑制, 束缚, 勒住
cure	n. 治疗, 治愈, 治疗法 vt. 治疗, 治愈, 改正, 腌制, 加工处理, 使硫化 vi. 受治疗, 被加工处理, 被硫化
curl	n. 拳曲, 鬈发 vt. 弄卷 vi. 拳曲, 弯曲
curly	a. 拳曲的, 卷毛的, 弯曲的
currency	n. 货币, 通货, 流通, 通用 [计] 货币, 货币型
current	n. 涌流, 趋势, 流 a. 流通的, 现在的, 当前的, 流行的 [计] 当前的
curriculum	n. 课程 [医] 课程, 学程
curse	n. 咒骂, 诅咒 vt. 诅咒, 咒骂
curtail	vt. 缩减, 剥夺, 简略 [法] 剥夺特权
curtains	n. [俚]灾难；窗帘（curtain的复数）
curve	n. 曲线, 弯曲, 曲线球 vt. 弯, 使弯曲 vi. 成曲形
cushion	n. 垫子, 橡皮软垫 vt. 加垫褥, 缓冲, 掩盖
custodian	n. 管理人, 保管人, 监护人 [经] 保管人, 管理人
custom	n. 习惯, 风俗, 海关, 自定义 a. 定制的 [计] 定制; 自定义
customary	a. 习惯的, 惯常的 [经] 通常的, 习惯的
customer	n. 消费者 [化] 顾客
customers	n. 客户；顾客（customer的复数）
cut	n. 切口, 割伤, 降低, 切, 割, 砍, 削, 伤口, 削减, 缩短, 删节, 通路 a. 经切割的, 缩减的 vt. 切, 割, 减少, 刺痛, 开辟, 雕刻, 删节, 缩短, 停止, 排斥, 切断, 关, 显出 vi. 切, 割, 砍, 刺痛, 相交, 抄近路, 剪辑 [计] 剪切
cute	a. 可爱的, 聪明的, 伶俐的 [医] 品他病
cutting	n. 切断, 切下, 路堑 [化] 切屑
cycle	n. 周期, 循环, 自行车, 一段时间, 整套 vi. 循环, 轮转, 骑自行车 vt. 使循环, 使轮转 [计] 环路; 周期; 循环
cycling	n. 骑脚踏车兜风, 骑脚踏车消遣 [机] 循环操作
cylinder	n. 圆筒, 圆筒状物, 汽缸, 柱面 [计] 柱面
cynical	a. 愤世嫉俗的, 讽刺的, 冷嘲的
daily	a. 每日的, 日常的 adv. 每日地, 日常地 n. 日报
dairy	n. 牛奶公司, 乳品店, 乳牛场
dam	n. 水坝, 障碍 v. 控制, 筑坝 [计] 直接存取法
damage	n. 损害, 伤害 v. 损害
damages	n. 赔偿金 [经] 损害赔偿; 伤害
damp	n. 潮湿, 湿气 a. 潮湿的 vt. 使潮湿, 使阻尼, 抑止 vi. 变潮湿, 衰减
dancer	n. 舞蹈演员, 跳舞者
danger	n. 危险, 威胁 [法] 危险, 危险物, 危机
dangerous	a. 危险的 [法] 危险的, 危害的
dark	n. 黑暗, 夜, 黄昏, 模糊 a. 黑暗的, 暗的, 深色的, 隐密的, 模糊的, 无知的
dart	n. 飞镖, 投射 vt. 投射 vi. 疾走, 突进
dash	n. 冲撞, 破折号, 短跑 vi. 猛冲, 冲撞 vt. 泼溅, 使猛撞, 搀和, 使破灭, 使沮丧
data	pl. 资料, 数据 [计] 数据; DOS内部命令:用于显示或设定系统的日期
database	n. 数据库 [计] 数据库
date	n. 日期, 约会, 枣椰树 vt. 约会, 定日期 vi. 注明日期, 过时
dawn	n. 破晓, 黎明 vi. 破晓
day	n. 天, 日子, 白天, 工作日 [医] 日(一昼夜), 昼, 白天
dazzle	v. (使)眼花, 炫耀 n. 耀眼
deadline	n. 最后期限, 截止期限 [经] 截止日期
deadlock	n. 僵局, 停顿 v. (使)停顿, (使)相持不下 [计] 死锁
deadly	a. 致命的, 致死的 adv. 非常, 如死一般地
deaf	a. 聋的 [医] 聋的
dean	n. 院长, 主持牧师 [法] 外交团长, 学院院长, 教务长
dearth	n. 缺乏, 粮食不足, 饥馑
debris	n. 碎片, 残骸 [医] 碎屑
debt	n. 债务, 罪过 [经] 借款, 欠款, 债务
decade	n. 十年, 十
decay	n. 衰退, 腐败 v. (使)衰退, (使)腐败
deceive	v. 欺骗, 行骗
December	n. 十二月
decent	a. 有分寸的, 得体的, 大方的
decimal	a. 十进位的, 小数的 n. 十进制, 小数 [计] 十进制, 小数点
decipher	vt. 译解, 解释 n. 密电译文
decision	n. 决定, 决心, 决断 [计] 判定
deck	n. 甲板, (汽车后部的)行李仓 vt. 装饰, 打扮, 装甲板 [计] 纸牌背面图案
declaration	n. 宣告, 说明, 宣布 [计] 说明
declare	v. 宣布, 声明, 申报, 断言
decline	n. 衰退, 跌落, 下降 vt. 使降低, 婉谢 vi. 下降, 衰落, 偏斜
decompose	v. 分解, (使)腐烂
decorate	v. 装饰
decoration	n. 装饰, 装饰品
decorations	n. 装修；装饰品（decoration的复数）
decrease	n. 减少, 减少量 v. 减少
decree	n. 法令, 判决, 天意 vt. 颁布, 判决 vi. 发布命令
decrepit	a. 衰老的
dedicate	vt. 献出, 贡献
dedicated	a. 专注的, 献身的
dedication	n. 奉献, 献身, 献辞 [计] 专用
deduce	vt. 推论, 演绎出 [法] 推断, 推出, 演绎
deduct	vt. 扣除, 减去 [经] 扣除, 减去, 折扣
deem	v. 认为, 相信
default	n. 违约, 不履行责任, 缺席, 默认值 v. 疏怠职责, 缺席, 拖欠, 默认 [计] 默认; 默认值; 缺省值
defeat	n. 败北, 失败 vt. 击败, 使落空
defect	n. 缺点 [医] 缺损, 缺陷
defence	n. 防卫, 防卫设备 [经] (诉讼程序中的)辩护
defendant	n. 被告 [经] 被告方
defer	vi. 推迟, 延期, 听从 vt. 使推迟, 使延期
defiance	n. 蔑视, 挑战 [法] 挑战, 藐视, 违抗
deficiency	n. 缺乏, 不足 [医] 缺乏, 不足
deficit	n. 赤字, 不足额 [医] 短缺
defile	vt. 弄脏, 污损, 败坏 vi. 以纵队前进 n. 隘路, 狭道
definite	a. 明确的, 一定的 [法] 明确的, 确切的, 一定的
definitive	n. 限定词 a. 限定的, 决定性的
deflate	vt. 放气, 抽出空气, 使缩小 vi. 缩小
deflect	vt. 转移, 使偏斜 vi. 偏斜
defraud	vt. 欺骗 [经] 骗取, 诈取, 欺骗
deft	a. 敏捷熟练的, 灵巧的
defy	vt. 藐视, 挑衅, 使落空 n. 挑战
degenerate	a. 堕落的 vi. 退化, 堕落 vt. 使变质, 使退化
degrade	v. (使)降级, (使)退化
degree	n. 程度, 度数, 学位, 度 [医] 度, 程度
delay	n. 耽搁, 迟滞 v. 耽搁, 延迟 [计] 延迟, 延时
delectable	a. 令人快乐的, 美味的, 使人愉快的
delegate	n. 代表 vt. 委派...为代表
delete	vt. 删除 [计] 删除
deliberate	a. 深思熟虑的, 故意的, 从容的 v. 仔细考虑
delicate	a. 细致优雅的, 微妙的, 美味的 [医] 柔弱的
delicious	a. 美味的
delinquency	n. 行为不良, 失职 [经] 毁约, 怠工, 旷职
delirium	n. 精神错乱, 说谵语状态, 狂热 [医] 谵妄, 发狂, 妄想
deliver	vt. 递送, 陈述, 释放, 发表, 引渡, 投递, 交付 [经] 交运
delivery	n. 递送, 交付, 分娩, 交货, 引渡 [化] 交货额
delude	vt. 迷惑, 蛊惑
deluge	n. 大洪水, 泛滥 vt. 使泛滥
democracy	n. 民主政治, 民主主义 [法] 民主, 民主政治, 民主政体
demolish	vt. 毁坏, 破坏, 粉碎
demonstrate	vt. 示范, 证明 vi. 示威
demonstration	n. 示范, 实证 [医] 示教, 实物教授
denial	n. 否认 [法] 否定, 否认, 拒绝接受
denomination	n. 名称, 教派, 面额 [经] 票面金额, 名称, (度量衡)
denote	vt. 指示, 表示
denounce	vt. 告发, 抨击, 谴责 [法] 谴责, 斥责, 告发
dense	a. 密集的, 浓厚的
dentist	n. 牙科医生 [医] 牙医师
deny	v. 否认, 拒绝
depart	vi. 离开, 出发, 背离, 违反, 去世
department	n. 部门, 系, 机关 [医] 部, 科
departmental	a. 部门的, 各部的, 分科的
dependent	n. 依赖他人者 a. 依赖的, 从属的
depict	vt. 描述, 描写
deplete	vt. 耗尽, 使衰竭 [医] 排除, 减少
depletion	n. 消耗, 耗尽, 放血 [医] 排除, 缺失(液体), 衰竭[状态](由于缺液)
deplore	vt. 悲悼, 哀叹, 对...深感遗憾
deposit	n. 存款, 定金, 堆积物 vt. 存放, 堆积 vi. 沉淀
depress	vt. 使沮丧, 压低, 降低, 使萧条 [化] 推下
depression	n. 不景气, 消沉, 沮丧, 洼地 [医] 抑郁[症], 阻抑, 压低, 凹, 窝, 衰退, 俯角
deprive	vt. 剥夺, 使丧失 [法] 剥夺, 剥夺, 夺去
depth	n. 深度, 深处, 深奥 [计] 深度
deputy	n. 副手，代理人
derelict	a. 被抛弃了的, 无主的, 玩忽职守的 n. 遗弃物, 被遗弃的人, 玩忽职守者
derive	vt. 得自 vi. 起源
descend	vi. 下降, 世代相传, 屈尊, 袭击 vt. 下降
descent	n. 降落, 家系, 侵袭, 血统 [医] 下降, 世代, 血统
description	n. 描述, 说明, 种类 [经] 说明书(物品), 品名种类, 货物名称
desert	n. 沙漠, 应得的赏罚, 功劳 a. 沙漠的, 不毛的 vt. 放弃, 遗弃, 擅离 vi. 逃掉
deserve	vt. 该得到, 值得 vi. 应得报答
design	n. 设计, 图样, 方案, 企图 v. 设计, 计划
designate	vt. 指定, 指明, 称呼 a. 已选出而未上任的
designer	n. 设计者, 谋划者, 制图者 [计] 设计员
desirable	a. 令人想望的, 可取的
desire	n. 欲望, 要求 vt. 想要, 请求 vi. 渴望
desk	n. 书桌, 办公桌, 工作台
desolate	a. 荒凉的
despair	n. 绝望, 失望 vi. 绝望
despatch	v. 派遣 n. 派遣
desperate	a. 不顾一切的, 危急的, 令人绝望的, 极渴望的
despise	vt. 轻视
destination	n. 目的地, 目标, 目的 [计] 目的文件, 目的单元
destine	vt. 注定, 预定
destiny	n. 命运, 定数
destructive	a. 毁灭性的, 破坏的, 有害的 [医] 破坏的, 毁坏的
detach	vt. 使分离, 分遣 [机] 摘下, 分离, 卸下
detail	n. 细节, 详情 vt. 详述, 选派 vi. 画详图 [计] 详细数据
detailed	a. 详细的, 复杂的 [法] 详细的, 详尽的
details	n. 详细资料；细节（detail的复数）
detain	vt. 扣留, 扣押, 耽搁 [法] 拘留, 扣押, 留住
detect	vt. 发现, 察觉, 探测 [法] 发现, 查明, 探测
detective	n. 侦探 a. 侦探的
deter	vt. 制止, 吓住, 威慑
detergent	n. 清洁剂 [化] 洗涤剂
deteriorate	v. (使)恶化
determination	n. 决心, 果断 [化] 判定; 测定
detest	vt. 厌恶, 憎恨
detriment	n. 损害, 损害物 [法] 损害, 伤害, 危害
detrimental	a. 有害的
devastate	vt. 毁坏 [法] 使荒废, 毁灭, 掠夺
devastating	a. 毁灭性的, (非正式)很好的, 引人注目的
development	n. 发展 [化] 展开
deviate	vi. 脱离, 偏离 vt. 使偏离 a. 脱离常规的 n. 脱离常规的人
devise	vt. 设计, 发明, 图谋, 遗赠给 n. 遗赠
devote	vt. 投入于, 献身
devour	vt. 吞食, 挥霍, 吞没
diagnose	v. 诊断
diagram	n. 图表；图解
dial	n. 刻度盘, 钟面, 转盘 v. 拨
dialect	n. 方言, 同源语
dialogue	n. 对话 vi. 对话 vt. 用对话表达
diameter	n. 直径 [医] 直经, 径
diary	n. 日记 [经] 日记簿
dictate	vi. 听写, 口述, 口授 vt. 口述, 使听写, 命令 n. 命令, 指挥, 指令
dictation	n. 听写, 口述, 命令
diet	n. 日常饮食, 议会 vt. 照规定饮食 vi. 忌食
differ	vi. 不一致, 不同 [机] 差异, 不同
difference	n. 不同, 差异 [计] 差分
different	a. 不同的 [机] 差动, 微分的, 差速器
differentiate	v. 区别, 区分
difficult	a. 困难的
difficulties	n. 困难( difficulty的名词复数 ); 难度; 难事; 麻烦
difficulty	n. 困难, 难点
diffuse	v. 散播, 传播 a. 散开的, 弥漫的
digest	n. 文摘 vi. 消化 vt. 消化, 理解 [计] 摘要
digital	a. 数字显示的, 数字的 n. 数字仪表, 数字式电子表(或时钟) [计] 数字, 数字式
dignity	n. 尊严, 高贵 [法] 尊严, 高位, 高贵
dilapidated	a. 破坏的；荒废的, 要塌似的
dilate	vi. 扩大, 详述, 膨胀 vt. 使膨胀
dilemma	n. 困境, (进退两难的)窘境
diligent	a. 勤勉的, 用功的
dilute	vt. 冲淡, 稀释 a. 淡的, 稀释的
dim	a. 暗淡的, 模糊的 vt. 使暗淡 [计] 数据解释模块
dimension	n. 尺寸, 次元, 面积, 维数 vt. 标出尺寸
diminish	v. (使)减少, (使)变小
din	n. 喧嚣 v. 絮絮不休地说, 喧闹
dine	vi. 用正餐, 进餐 vt. 宴请
dingy	a. 暗淡的, 昏暗的, 邋遢的
dining	n. 正餐, 宴会
dinner	n. 晚餐, 正餐, 宴会
dioxide	n. 二氧化物 [医] 二氧化物
dip	v. 浸, 降下, 把(手、勺等)伸入, 舀取 n. 浸, 涉猎 [计] 双列直插式组件, 分布式输入输出系统, 双排直插封装
diploma	n. 文凭, 毕业证书 [医] 文凭
diplomas	pl. 公文, 文书, 执照, 特许证, 毕业文凭, 学位证书, 奖状
diplomat	n. 外交官, 有外交手腕的人 [法] 外交家, 外交官, 有权谋的人
diplomatic	a. 外交的, 老练的 [法] 外交的, 外交上的, 文献上的
direct	a. 直接的, 坦白的 vt. 指示, 指挥, 命令, 导演 vi. 指导, 指挥 adv. 直接地
director	n. 主管, 导演, 董事 [计] 寻向偶极子; 指挥仪
directory	n. 目录, 工商名录, 指南 [计] 目录
disable	vt. 使失去能力, 使残废, (律)使无资格 [计] 使无效, 禁止, 关闭
disabled	a. 残废的, 有缺陷的, 失效的 [计] 失效的
disagreement	n. 不合, 争论, 不一致 [法] 不一致, 不同意, 陪审团的意见不一
disarray	vt. 弄乱, 使混乱, 使脱去衣服 n. 无秩序, 杂乱, 不整齐的衣着
disaster	n. 灾祸, 不幸, 彻底失败
disc	n. 圆盘, 唱片 vt. 灌唱片
discard	vt. 丢弃, 抛弃 vi. 垫牌 n. 垫牌, 抛弃
discern	v. 辨别, 看清楚, 了解
discharge	vt. 卸下, 放出, 解雇, 拔染, 履行, 放电 vi. 卸货, 流出 n. 卸货, 流出, 放电
discipline	n. 训练, 纪律 vt. 训练, 惩罚
disclose	vt. 揭露, 透露 [法] 揭发, 揭露, 公开
disco	n. 夜总会, 迪斯科, 的士高
discord	n. 不调和, 不和 vi. 不一致, (声音)刺耳
discount	n. 折扣, 贴现率 vt. 打折扣 vi. 贴现
discovery	n. 发现, 被发现的事物 [法] 要求告知, 发现, 发觉
discreet	a. 小心的, 慎重的
discrepancy	n. 不符合, 差异, 不相符之处 [化] 不符值; 偏差值
discrete	a. 不连续的, 离散的 [计] 离散的
discriminate	v. 区别, 差别待遇
discussion	n. 讨论
disdain	n. 蔑视 vt. 蔑视, 鄙弃
disease	n. 疾病, 弊病 [医] [疾]病
diseases	n. 病害；疾病；疾病种类；病（disease的复数）
disguise	n. 假面目, 假装 vt. 假装, 隐瞒
disgust	n. 厌恶, 嫌恶 vi. 令人厌恶 vt. 使作呕
dishes	n. 餐具
dismay	n. 沮丧 vt. 使惊愕, 使气馁
dismiss	vt. 解散, 开除, 解职 vi. 解散 [计] 解散
disorder	n. 杂乱, 混乱 vt. 扰乱, 使失调
dispatch	vt. 派遣 n. 派遣, 急件 [计] 调度
dispel	vt. 驱散, 驱逐
disperse	vt. 分散, 传播, 散开 vi. 分散 a. 分散的 [计] 分散
displace	vt. 移置, 替换, 转移
display	n. 显示, 陈列, 炫耀, 显示器 vt. 陈列, 显示, 表现, 夸示 [计] 显示器; 显示
disposal	n. 丢掉, 处理, 排列, 销毁, 布置 [医] 处理, 处置
dispose	vt. 处理, 排列, 布置 vi. 处置
disposition	n. 性情, 处置, 处理, 布置 [医] 素因, 性情
dispute	n. 争论 v. 争论
disputes	n. 辩论( dispute的名词复数 ); 争端; （劳资）纠纷; 罢工 v. 辩论, 争论( dispute的第三人称单数 ); 争夺; 阻止; 就…进行辩论
disregard	n. 忽视, 漠视 vt. 忽视, 不顾
disrupt	a. 分裂的, 中断的 vt. 使分裂, 使瓦解
dissertation	n. 论文
dissipate	vt. 散失, 驱散, 浪费 vi. 消散, 放荡
dissolve	v. 溶解, 解散
distance	n. 距离, 远方, 遥远 [计] 位距
distant	a. 远的, 疏远的 [经] 远期的
distend	v. (使)膨胀, (使)扩张
distil	vt.vi. 蒸馏, 提取...的精华, 用蒸馏法提取 vi. 滴下, 渗出
distinct	a. 清楚的, 显著的, 不同的
distinction	n. 区别
distinguish	v. 区别, 辨别
distort	vt. 扭曲, 歪曲 [法] 歪区, 曲解, 纂改
distract	vt. 转移, 分心, 使发狂
distraction	n. 娱乐, 分心的事物, 分心 [医] 注意力分散, 内脱位, 牙弓过宽
distress	n. 苦恼, 贫困, 痛苦 vt. 使苦恼 a. 亏本出售的
distribute	vt. 分配, 散布, 分发 [经] 分配, 分发
distribution	n. 分配 [计] 分布
disturb	vt. 扰乱, 妨碍, 使不安 [法] 滋扰, 扰乱
disturbance	n. 扰乱, 不安, 忧虑 [化] 扰动; 干扰; 失调
ditch	n. 沟渠 vt. 在...开沟 vi. 开沟
diverse	a. 不同的, 变化多的
diversion	n. 转移 [医] 转向
divert	vt. 转移, 使欢娱 vi. 转移
dividend	n. 被除数, 股利 [计] 被除数
divine	a. 神的, 神圣的, 非凡的 n. 神学家
divorce	n. 离婚 vt. 与...离婚
dizzy	a. 晕眩的, 眼花缭乱的 vt. 使晕眩
dock	n. 码头, 船坞, 被告席, 尾巴的骨肉部分 vt. 使靠码头, 使(船)进港, 剪短 vi. 进港
doctor	n. 医生, 博士 vt. 授以博士学位, 诊断, 修改 vi. 行医
doctors	n. 医生（doctor的复数）
doctrine	n. 教条, 学说 [医] 学说
documents	n. 文档（document的复数形式）
dodge	v. 避开, 躲避 n. 诡计, 躲藏
dole	n. 救济品, 失业救济金 vt. 发放救济
domain	n. 领域, 领土, 产业, 范围 [计] 域, 区域, 支配命令
dome	n. 圆顶 vt. 加圆顶 vi. 成圆顶状
domestic	a. 家庭的, 国内的, 驯养的 [医] 家庭的, 家用的
dominant	a. 占优势的, 支配的 [医] 优性的, 显性的
dominate	v. 支配, 占优势
donate	v. 捐赠
donation	n. 捐赠物, 捐款, 捐赠 [经] 赠品, 捐款, 捐赠
donations	n. 捐款；捐赠（donation的复数）
doom	n. 厄运, 不幸, 法律, 宣告, 判决, 死亡 vt. 命中注定, 判决
doors	n. 大门；入口；通道（door的复数）
dormant	a. 睡眠状态的, 静止的 [医] 休眠的, 不活动的, 休止的
dose	n. 剂量, 服用量 vt. 给药, (用药)医治 vi. 服药
dot	n. 点, 圆点, 小数点, 小东西, 嫁妆 vt. 作小点记号, 加小点于 vi. 打上点 [计] 点
double	n. 两倍 a. 两倍的, 双重的 vt. 使加倍 vi. 加倍, 代替, 快步走 [计] 双精度型
doubtful	a. 可疑的, 疑心的, 不明确的 [法] 怀疑的, 有疑问的, 未确的
doubtless	a. 无疑的, 确定的 adv. 无疑地, 确定地
downpour	n. 倾盆大雨；注下
downtown	n. 市中心区 a. 市中心的 adv. 往闹市区
doze	vi. 打瞌睡, 假寐 vt. 打瞌睡度过 n. 瞌睡
draft	n. 气流, 草稿, 汇票, 草案 vt. 起草, 征兵 [计] 草稿
drain	n. 排水沟, 消耗, 排水 vt. 排出, 喝光, 耗尽 vi. 排水, 流干
drainage	n. 排水 [医] 引流[法], 导液[法], 排水[设备]
drama	n. 戏剧, 戏剧艺术
dramatic	a. 戏剧性的, 生动的
drastic	a. 激烈的 [医] 峻泻药, 剧烈的
drawback	n. 缺点, 退税 [法] 退款, 退税
drawer	n. 抽屉, 开票人 [计] 抽屉
draws	n. 铸件孔穴；图画（draw的复数）
dread	n. 恐惧, 可怕的人(或事) a. 可怕的, 可怖的 v. 恐惧, 害怕
dreadful	a. 可怕的
dreary	a. 沉闷的
drench	vt. 使湿透, 使充满 n. 滂沱大雨, 弄湿
dress	n. 服装, 覆盖物 vi. 穿着 vt. 给...穿衣, 整理
dressing	n. 调味品, 穿衣, 化妆 [化] 追肥
drift	n. 漂流物, 漂流, 动向 v. (使)漂流
drill	n. 钻孔机, 钻子, 播种机, 粗斜纹布 v. 训练, 钻孔
drinking	n. 喝, 喝酒
drinks	n. 饮料, 饮品；喝酒（drink复数）
driver	n. 驾驶员, 驱动器, 驱动程序 [化] 驱动器
driving	n. 赶, 操纵, 驾驶 a. 推进的, 强劲的, 精力旺盛的
drop	n. 滴, 微量, 落下, 空投 vi. 放下, 掉下, 下降 vt. 使滴下, 放下, 丢失, 遗漏 [计] 投入, 投入点, 接入点, 分接点
drop-off	n. 下降, 减少
drop-out	[计] 漏失信息; 丢""1""
dropout	n. 退学学生, 中途退学 [电] 离去
drought	n. 干旱, 缺乏
drown	vi. 淹死 vt. 把...淹死, 淹没
drowse	n. 瞌睡 vi. 打瞌睡 vt. 使瞌睡
drowsiness	n. 睡意 [医] 倦睡, 瞌睡
drudgery	n. 苦差事, 苦工
drugs	n. 毒品, 药物
dual	a. 双重的, 双的 n. 双数
dub	vt. 配音, 轻点, 授予称号, 击 n. 一下击鼓声, 笨蛋
dubious	a. 可疑的, 不确定的
due	n. 应得的东西, 应付款 a. 到期的, 应得的, 应付的, 约定的
dull	a. 钝的, 无趣的, 呆滞的, 阴暗的 vt. 使迟钝, 使阴暗, 缓和 vi. 变迟钝, 减少
duly	adv. 恰当地, 充分地, 适当地, 及时地
dumb	a. 哑的, 不说话的, 无声音的 [医] 哑的
dump	n. 垃圾场 vt. 倾倒, 倾销 vi. 倒垃圾, 倾销商品 [计] 转出; 转储; 倾卸; 切断电源
duplicate	n. 副本, 复本, 复制品 a. 复制的, 二重的 vt. 复制, 使加倍 [计] 复制
durable	a. 持久的, 耐用的
duration	n. 持续时间, 持续 [计] 持续时间
dust	n. 灰尘, 尘埃, 粉末, 花粉, 土, 骚乱 vt. 拂去灰尘, 撒, 弄成粉末 vi. 拂去灰尘, 化为粉末
duties	n. 关税（duty的复数）
duty	n. 责任, 关税, 职务, 尊敬 [化] 职责
dwarf	n. 矮子, 侏儒 v. (使)变矮小
dwell	vi. 居住, 居住(于), 存在(于)
dwindle	vi. 减少, 缩小, 衰落 vt. 使缩小
dynamic	a. 动态的, 有活力的, 有力的, 动力的, 不断变化的 n. 动力, 动态 [计] 动态的
eagle	n. 鹰, 鹰状标饰
ease	n. 安乐, 安逸, 悠闲 vt. 使安乐, 使安心, 减轻, 放松 vi. 减轻, 放松, 灵活地移动
Easter	n. 复活节
eastern	n. 东方人, 东正教徒 a. 东方的, 向东的, 自东的
eccentric	n. 怪人, 偏心圆 a. 古怪的, 反常的, 不同圆心的
echo	n. 回声, 回音, 回波 vi. 发回声, 随声附和 vt. 摹仿, 重复, 反射 [计] 回显; DOS批处理命令:控制MS-DOS命令是否在屏幕上显示
eclipse	n. 日食, 月食, (地位名誉等的)消失 vt. 引起日食, 引起月食, 使黯然失色
ecology	n. 生态学, 社会生态学 [化] 生态学
economic	a. 经济上的, 实用的, 节省的 [经] 经济的
economical	a. 节俭的, 经济的, 合算的 [经] 经济的, 节约的
economics	n. 经济学 [经] 经济学
economy	n. 经济, 理财, 节约 [医] 经济, 整体
eddy	n. 逆流, 漩涡 v. (使)起漩涡
edge	n. 边缘, 尖锐, 刀刃, 优势 vt. 使锐利, 挤进, 镶边 vi. 缓缓移动
edible	n. 食品, 食物 a. 可食用的
edit	vt. 编辑, 编校, 修订, 剪辑 [计] 编辑; DOS外部命令:该命令是一个用于编辑文本文件的全屏幕编辑程序
edition	n. 版本, 版, 翻版
editor	n. 编者, 编辑, 主笔, 编辑器, 编辑装置 [计] 编辑器
editorial	n. 社论, 评论 a. 编辑的, 主笔的, 社论的
education	n. 教育, 训练, 教育学 [医] 教育, 训练
educational	a. 教育的, 教育性的
effect	n. 结果, 影响, 效果, 印象 vt. 实行, 引起, 完成 [计] 效果
effective	a. 有效的, 有力的, 实际的 n. 有生力量
effectively	adv. 有效地, 有力地, 实际上
effects	n. 财物, 个人财产 [经] 动产, 财物
efficient	a. 有效率的, 能干的
ego	n. 自我 [医] 自我
Egyptian	n. 埃及人 a. 埃及的, 埃及人的
eject	vt. 逐放, 放逐, 喷射 [化] 排出
eke	vt. 补充, 增加
elaborate	a. 精细的, 详尽的, 精心计划(或制作)的 vt. 详细地说明, 用心地制作, 发挥 vi. 变复杂, 作详细说明
elapse	vi. 逝去, 过去 n. 逝去, 过去
elastic	n. 松紧带, 橡皮筋 a. 有弹性的, 能伸缩的, 可通融的
elated	a. 兴高采烈的
elbow	n. 手肘, 弯头, 扶手 v. 用手肘推开, 推挤
elder	n. 年长者, 老人, 前辈 a. 年长的, 资深的
elderly	a. 过了中年的, 稍老的
electrical	a. 电的, 有关电的 [医] 电的
electrician	n. 电学家, 电气技师, 电工 [化] 电工; 电气工人
electricity	n. 电, 电流, 电学, 热情, 电力供应 [化] 电学; 电
electronic	a. 电子的 [计] 电子工业协会接口
electronics	n. 电子学 [计] 电子学
elegant	a. 优雅的, 端庄的, 高雅的
elementary	a. 初步的, 基本的 [医] 元素的, 基础的, 初级的
elements	n. 原理, 基础
elevate	vt. 举起, 提拔, 鼓舞
elevator	n. 电梯, 升降机 [化] 提升机
elicit	vt. 引出, 推导出, 引起
eligible	a. 有资格当选的, 合格的 n. 有资格者, 合格者, 适任者
eliminate	vt. 除去, 排除, 剔除, 消除
elite	n. 精华, 精锐, 中坚分子
eloquent	a. 雄辩的, 有口才的, 有说服力的
elsewhere	adv. 在别处
email	n. 电子信函
embargo	n. 封港令, 禁运 vt. 禁止出入港口, 禁运
embark	vi. 乘船, 着手, 从事, 上飞机 vt. 使上船, 使上飞机, 使从事
embarrass	vt. 使困窘, 使局促不安, 阻碍
embassy	n. 大使馆, 大使馆全体人员 [经] 大使馆
embed	vt. 使插入, 使嵌入, 使深留脑中 [计] 嵌入
embody	vt. 具体表达, 使具体化 [经] 合并, 具体化, 具体表现
embrace	n. 拥抱 vt. 拥抱, 互相拥抱, 包含, 收买 vi. 拥抱
emerge	vi. 浮现, 形成, 出现, (事实)显露
emergencies	n. 紧急需要；紧急事件
emergency	n. 紧急状况, 紧急事件, 紧急需要 [化] 紧急情况
emigrate	v. (使)移居, (使)移民
eminent	a. 显赫的, 杰出的, 有名的
emit	vt. 发出, 放射, 发表(意见等), 散发, 发行 [化] 放射
emotion	n. 情绪, 激动, 强烈的情感 [医] 情绪, 情感
emperor	n. 皇帝, 君主
emphasize	vt. 强调, 加强语气, 着重
empirical	a. 完全跟据经验的, 经验主义的 [医] 经验主义的
employee	n. 职员, 员工, 受雇人员 [化] 职工; 雇员
employees	n. 员工；雇员；从业人员（emploee的复数）
employer	n. 雇主, 老板 [经] 雇主, 业主
employment	n. 雇用, 职业, 工作 [经] 职业, 雇用, 职工招请
empty	a. 空的, 空虚的, 空腹的, 空洞的 n. 空的东西, 空车 vt. 倒空, 使变空, 使排出 vi. 流空 [计] 空
enclose	vt. 围绕, 圈起, 放入封套, 附上
enclosure	n. 附件, 围墙, 围绕 [化] 机壳; 外壳
encounter	n. 相会, 相遇, 遭遇 vt. 遇见, 邂逅, 会战 vi. 偶然相遇
encyclopedia	n. 百科全书
end	n. 结束, 终点, 目标, 末端, 梢, 死亡, 残余 v. 结束, 终结, 终止 [计] 端; 结束
endeavour	n. 努力, 力图, 尽力 vi. 努力, 力图, 尽力
ending	n. 终止, 终了, 收场 [医] 末梢
endorse	vt. 支持, 赞同, 背书于, 签署 [经] 赞成, 背书
endow	vt. 捐赠, 捐助, 赋予 [法] 赠送财产给, 分给寡妇一份遗产, 授与
endurance	n. 忍耐, 忍耐力, 耐性 [机] 持九性
energetic	a. 精力充沛的, 积极的
energies	n. 活力( energy的名词复数 ); [物理学]（原子、电、辐射的）能; [常用复数]精力; （有效地发挥的）力量
energy	n. 精力, 精神, 活力, 能量 [化] 能; 能量
enforce	vt. 强迫, 执行, 坚持 [经] 予以强制执行
engage	vi. 答应, 从事, 交战 vt. 使忙碌, 雇佣, 预定, 使从事于, 使参加
engagement	n. 诺言, 约会, 婚约, 交战 [医] 衔接
engine	n. 引擎, 发动机, 机车 vt. 安装发动机于
engineer	n. 工程师, 工兵 vt. 设计, 监造, 精明地处理, 策划
engineering	n. 工程学, 工程, 操纵 [化] 机器; 机器学
engineers	n. 工程师；机械师（engineer的复数）
England	n. 英格兰 [法] 英格兰, 英国
engrave	vt. 刻上, 雕刻, 铭记
engross	vt. 用大字体书写, 独占(市场), 使全神贯注 [法] 正式誊写, 以大字写, 囤积
enhance	vt. 提高, 加强, 增加
enlighten	vt. 教育, 启发, 启蒙, 开导, 教导
enormous	a. 巨大的, 庞大的
enquire	v. 询问
enquiry	n. 询问 [经] 询价, 询盘
enrich	vt. 使富足, 使肥沃
enroll	vt. 登记, 使加入 vi. 参军, 注册
enrollment	n. 登记, 注册, 入伍 [经] 登记, 注册
enrolment	n. 登记, 注册, 入伍, 入学, 入会, 注册人数, 入学人数
ensemble	n. 全体, 合唱曲, (女人的)全套服装 [化] 总体; 整体; 系综
ensue	vi. 跟着发生, 继起 vt. 追求
entail	vt. 使成为必需, 需要, 使承担, 遗传给 n. 限定继承
entangle	vt. 使纠缠, 卷入, 使混乱
enterprise	n. 企业, 事业心, 进取心, 干事业 [计] 企业
entertainment	n. 娱乐, 款待, 娱乐表演
enthusiasm	n. 巨大的热情, 热心
enthusiastic	a. 狂热的, 热心的, 热烈的
entitle	vt. 给...权利, 取名为, 给予名称, 叫做 [法] 给...权利, 使有资格, 称呼
entity	n. 实体, 实存物, 存在 [计] 实体
entrance	n. 入口, 进入点, 入场, 入学, 进入, 开始(阶段), 就任 vt. 使出神, 使入迷 [计] 入口
entreat	v. 恳求, 乞求
entrepreneur	n. 企业家, 主办人 [经] 承包商, 企业家
entry	n. 登录, 条目, 进入, 入口, 报关 [计] 登录项, 输入项, 条目
environment	n. 环境, 外界, 围绕 [计] 环境
environmental	a. 周围的, 环境的 [经] 环境的, 环保的
envisage	vt. 面对, 正视, 想象
envy	n. 羡慕, 嫉妒 vt. 羡慕, 嫉妒
enzyme	n. 酶 [化] 酶
ephemeral	a. 朝生暮死的, 短命的, 短暂的 [医] 暂时的
epidemic	n. 传染病, 流行病 a. 流行的, 传染性的
episode	n. 插曲, 插话, 有趣的事件, 一段情节 [医] 插话, 插曲, 发作
epoch	n. 新纪元, 时代, 时期
equal	n. 对手, 匹敌, 同辈 a. 相等的, 平等的, 胜任的, 合适的, 平静的, 不相上下的 vt. 等于, 比得上 [计] 等长度编码
equation	n. 相等, 等式, 平衡 [化] 方程式; 等式; 反应式; 公式
equator	n. 赤道 [医] 赤道, 中纬线
equilibrium	n. 平衡, 平静, 均衡 [化] 平衡
equipment	n. 装备, 设备, 才能 [化] 设备; 装备; 装置
equitable	a. 公平的, 公正的 [法] 公平的, 公正的, 平衡法的
equity	n. 公平, 公正 [经] 权益, 产权
equivalent	n. 同等物, 等价物, 相等物 a. 相等的, 相当的, 同意义的 [计] 等价的
equivocal	a. 意义不明确的, 模棱两可的 [医] 双关的, 两可的
eradicate	vt. 根除, 扑灭, 根绝, 消灭
erase	vt. 抹去, 擦掉 [计] 清洗; 擦除; 抹除; DOS内部命令:从磁盘上删除一个或多个文件
erect	a. 直立的, 竖立的, 笔直的 vt. 使竖立, 使直立, 树立, 建立 vi. 勃起
erosion	n. 腐蚀, 冲蚀, 侵蚀 [化] 磨耗; 侵蚀
errand	n. 任务, 差使, 使命
erratic	n. 古怪的人, 漂泊无定的人 a. 不稳定的, 奇怪的
erroneous	a. 错误的, 不正确的 [法] 错误的, 不正确的
erupt	vi. 爆发 vt. 喷出
escalate	vi. 逐步扩大, 逐步升高, 逐步增强 vt. 使逐步上升
escalator	n. 电动扶梯, 自动扶梯 [机] 升降阶梯
escort	n. 护送者, 护卫者, 护航舰 vt. 护卫, 护送
essay	n. 随笔, 短文, 评论, 企图 vt. 试图
essence	n. 实质, 本质, 香精 [化] 香精
essential	n. 要素, 要点, 本质 a. 必要的, 重要的, 本质的 [计] 本质冒险
establish	vt. 建立, 确立, 制定 vi. 移植生长
estate	n. 不动产, (人生的)阶段, 阶层, 财产 [经] 房地产, 遗产, 财产
esteem	n. 尊敬, 尊重 vt. 尊敬, 尊重, 认为
estimate	n. 估计, 判断 vt. 估计, 评价, 判断 vi. 估计
eternal	a. 永恒的, 永远的, 不灭的
ethnic	a. 人种的, 种族的 [医] 人种的
etiquette	n. 礼仪, 礼节, 成规 [法] 规则, 成规, 礼节
Europe	n. 欧洲
European	n. 欧洲人 a. 欧洲的, 欧洲人的
evacuate	v. 疏散, 撤出, 排泄
evade	v. (巧妙地)逃脱, 规避, 逃避
evaluate	vt. 评估, 评价, 赋值
evaporate	vi. 蒸发, 失去水分, 消失 vt. 使蒸发, 使脱水, 使消失
even	a. 平坦的, 相等的, 连贯的, 均等的, 公平的, 偶数的, 平均的, 平衡的, 恰好的 vt. 使平坦, 使相等 vi. 变平, 成为相等 adv. 甚至, 实际上, 完全, 十分 n. 偶数, 偶校验 [计] 偶数, 偶校验
evening	n. 傍晚, 晚间, 末期
event	n. 事件, 结果, 事情的进程, 竞赛项目 [计] 事件
eventually	adv. 最后, 终于
everlasting	a. 永恒的, 持久的 n. 上帝, 神
evict	vt. 逐出, 赶出, 驱逐 [法] 逐出, 驱逐, 没收
evidence	n. 根据, 证据, 迹象 [经] 证据, 凭证
evoke	vt. 唤起, 引起, 召(魂) [法] 提审, 移送
evolution	n. 进化, 发展, 进展, (气体)放出, 开方 [医] 进化, 演化, 旋出
exacerbate	vt. 使恶化, 使增剧, 激怒, 使加剧
exaggerate	v. 夸大, 夸张
exam	n. 考试, 测验
examination	n. 考试, 测验, 审查 [医] 检查, 诊察
example	n. 例子, 样本, 实例 [化] 实例
examples	n. 例子；列证（example的复数形式）
exams	n. 考试；检查（exam的复数）
exasperate	vt. 使恼怒, 激怒, 恶化 a. 糙面的, 恼怒的, 激怒的
excavate	v. 挖空, 挖出, 凿通
exceed	vt. 超过, 超越, 胜过 vi. 超过其他
exceedingly	adv. 极端地, 极度地, 非常
excel	vt. 胜过, 优于, 擅长 vi. 胜过其他
exception	n. 例外, 除外, 异议 [计] 例外; 异常
exceptional	a. 例外的, 异常的, 特别的
excerpt	n. 摘录 v. 引用, 摘录
excess	n. 过度, 剩于, 超过, 超额 a. 过量的, 额外的
exchange	n. 交换, (电话)交换局, 交换机, 汇兑, 交易所 v. 交换, 交易, 兑换 [计] 交换; 电话局
excitement	n. 刺激, 兴奋 [医] 兴奋, 激动
exciting	a. 令人兴奋的, 刺激的 [电] 激磁
exclaim	v. 大叫, 呼喊, 大声叫
exclude	vt. 除外, 排除, 排斥 [医] 除外(诊断)
exclusive	a. 排外的, 独占的, 唯一的 [计] 独占的
exclusively	adv. 排他地, 仅仅, 专门, 只, 仅, 唯一地, 专有地
excrement	n. 排泄, 大便 [医] 粪便
excursion	n. 远足, 游览圆, 短程旅行 [医] 移动, 离轨, 逸出
excuse	vt. 原谅, 申辩, 做为...的托辞 n. 致歉, 理由, 饶恕, 借口
execute	vt. 执行, 实行, 完成, 处死, 制成 [计] 执行
execution	n. 实行, 完成, 执行, 死刑 [计] 执行
executive	n. 执行部门, 执行委员会, 执行者, 经理主管人员 a. 执行的, 善于执行的, 善于经营的 [计] 执行程序
exemplify	vt. 例证, 例示 [法] 制作经公章证明的誊本, 例证
exempt	n. 免税者, 被免除义务者 a. 免除的 vt. 使免除, 豁免
exercise	n. 行使, 执行, 运动, 练习, 作业 vt. 运用, 练习, 运动 vi. 练习, 锻炼
exert	vt. 发挥, 运用, 施以影响 [法] 施加, 产生, 行使
exhaust	n. 排气, 排气装置, 废气 vt. 抽完, 用尽, 耗尽, 使精疲力尽 vi. 排气
exhibition	n. 表现, 展览会, 展览品 [医] 投药, 展览, 展出
exhilarate	vt. 使高兴, 使愉快, 鼓励
exhort	v. 劝诫, 忠告
exile	n. 放逐, 流放, 被放逐者 vt. 放逐, 流放, 使背井离乡
existence	n. 存在, 生存 [法] 存在, 存在状态, 实体
existent	a. 存在的, 生存的, 现存的 [医] 生存者
existing	a. 存在的, 目前的, 现存的, 现有的 [计] 现成的, 已有的, 现存的
exorbitant	a. 过度的, 过高的, 过分的
exotic	a. 异国的, 外来的 n. 外来人, 外来物, 舶来品
expand	vt. 使膨胀, 详述, 扩张 vi. 张开, 发展 vt. 展开 vi. 展开 [计] 展开; DOS外部命令:将原始DOS磁盘上的压缩文件解压缩并拷贝到硬盘上
expansion	n. 扩充, 开展, 膨胀 [计] 扩展
expectancy	n. 期待, 期望的事物, 嘱望, 希望, 期望, 预期 [医] 预期
expedient	n. 权宜之计 a. 权宜的, 方便的, 有用的
expedition	n. 远征, 探险队, 迅速
expel	vt. 驱逐, 逐出, 排出, 开除 [医] 排除, 迫出
expend	vt. 花费, 消耗, 用光
expenditure	n. 开支, 费用, 用光, 消费额 [经] 支出, 费用, 消费
expenses	n. 开支, 经费, 费用 [法] 开支, 支出, 经费
expensive	a. 贵的, 奢华的, 费用浩大的, 乱化钱的 [经] 高价的, 昂贵的, 浪费的
experience	n. 经历, 经验, 体验 vt. 经历, 经验, 体验
experienced	a. 富有经验的, 老练的, 熟练的
experiment	n. 实验, 试验, 实验仪器 vi. 实验, 尝试
experimental	a. 实验的, 根据实验的 [医] 实验的
experiments	n. 实验( experiment的名词复数 ); 试验; 尝试; 实践
expert	n. 专家, 行家 a. 老练的, 内行的, 专门的 [计] 高级
expertise	n. 专家意见, 专门技术 [法] 专门知识, 专家意见
expire	vi. 期满, 呼气, 断气 vt. 呼出
explicit	a. 详述的, 清楚的, 直言的
explode	vi. 爆炸, 爆发, 激增 vt. 使爆炸
exploit	n. 功绩, 勋绩 vt. 开发, 利用, 开拓, 剥削
explore	v. 探险, 探测, 探究
explosion	n. 爆发, 激增, 爆炸(声) [化] 爆炸
explosive	n. 炸药, 爆破音 a. 易爆发的, 爆炸的, 暴躁的
export	n. 输出品, 输出 vt. 输出, 出口 vi. 输出物资 [计] 导出
expose	vt. 使暴露, 使曝光, 揭穿, 陈列 [医] 暴露, 露置
exposition	n. 阐述, 讲解, 说明, 博览会, 展览会 [经] 展览会, 集市, 义卖市场
exposure	n. 暴露, 揭发, 揭露 [化] 曝光量; 照射; 照射量
expulsion	n. 逐出, 开除, 驱逐, 排气 [医] 逼出
exquisite	a. 精致的, 细腻的, 敏锐的
extend	v. 扩充, 延伸, 伸展, 扩大 [计] 扩展
extension	n. 延长, 扩充, 范围, 扩展名 a. 伸缩的 [计] 扩展名, 扩充名
extensive	a. 广的, 广泛的, 多方面的 [经] 广大的, 扩大的
extent	n. 范围, 程度, 区域 [计] 范围
exterior	n. 外部, 表面, 外貌 a. 外部的, 外在的, 表面的
exterminate	vt. 扑灭, 消灭, 根绝
external	n. 外部, 外面 a. 外部的, 客观的, 表面的
extinct	a. 熄灭的, 灭绝的, 耗尽的 [法] 消灭了的, 过时的, 无效的
extinguish	vt. 熄灭, 使消亡, 压制, 使减色 [医] 消灭
extort	vt. 勒索, 敲诈, 强要 [医] 外旋
extra	n. 额外的事物, 另外的收费 a. 额外的, 特别的 adv. 额外地, 特别地, 非常地
extract	n. 榨出物, 精汁, 摘录, 选段 vt. (费力地)取出, 采掘, 榨取, 摘录, 吸取 [计] 提取
extravagant	a. 奢侈的, 挥霍无度的, 浪费的
extreme	n. 极端, 末端 a. 极端的, 尽头的, 极度的, 偏激的
exuberant	a. 繁茂的, 丰富的, 生气勃勃的 [医] 生成过多的, 高度增生的
eye	n. 眼睛, 视力, 看 vt. 看, 注视
eyesight	n. 视力, 目力
fabric	n. 织物, 布, 结构, 构造, 建筑物 [经] 组织, 建筑物, 工厂
fabricate	vt. 制造, 建造, 装配, 伪造
fabulous	a. 传说的, 寓言般的, 难以置信的
face	n. 脸, 面容, 正面, 外观 vt. 面对, 朝, 正视, 面临 vi. 朝, 向 [计] 现场可改变的控制元件
facet	n. (多面体的)面, 方面, 琢面 [医] 小平面, 小面
facilitate	vt. 使容易, 促进, 帮助 [法] 使容易, 使便利, 推进
facilities	n. 工具, 设施, 设备
facility	n. 容易, 灵巧, 设备 [计] 设施; 设备; 装备
factor	n. 因素, 因数, 系数, 基因, 代理人 [计] 因式
factories	n. 工厂, 车厂（factory复数形式）
factors	n. 因素（factor的复数）
factory	n. 工厂, 产生地, 代理店 [经] 工厂, 代理店, 商行在国外的代理处
faculty	n. 才能, 能力, 全体教员, (大学的)系 [医] 能力, [大学]院系
fade	vi. 褪色, 消失, 凋谢 vt. 使褪色 n. 淡入, 淡出 a. 平淡的
fahrenheit	a. 华氏温度计的 n. 华氏温度计
failure	n. 失败, 失败者, 不足, 缺乏, 破产 [计] 故障; 失效
faint	n. 昏厥, 昏倒 a. 模糊的, 微弱的, 无力的 vi. 昏倒, 变得微弱
faith	n. 信心, 信任, 忠实, 保证 [法] 信任, 信仰, 信念
fake	n. 假货, 欺骗, 诡计 a. 假的 vt. 假造, 仿造 vi. 伪装
falcons	n. 猎鹰；隼鹰队；猎鹰导弹（falcon的复数形式）
fall	n. 落下, 瀑布, 采伐量, 下降, 落差, 降低, 堕落, 秋天 vi. 倒下, 落下, 来临, 失守, 阵亡, 下跌, 减弱, 倾斜, 垮台, 轮到, 变成, 降低 a. 秋天的
fallacy	n. 错误的观念(或信念), 谬见, 谬论 [医] 错觉, 幻觉, 虚妄
fallible	a. 易错的, 可能犯错的
falter	vt. 支吾地说 vi. 支吾, 蹒跚地走 n. 颤抖, 支吾, 踌躇
fame	n. 名望, 名声, 传说
familiar	a. 熟悉的, 常见的, 亲密的 n. 熟友, 常客
families	n. 家族；家庭（family的复数）
family	n. 家庭, 家人, 族 a. 家庭的
famine	n. 饥荒, 缺乏, 饥饿
famous	a. 出名的, 极好的
fanatic	n. 狂热者, 盲信 a. 狂热的, 盲信的
fancy	n. 想象力, 幻想, 喜好 a. 想象的, 精美的, 新奇的, 奇特的, 高价的, 特级的 vt. 想象, 设想, 相信, 喜爱 vi. 想象, 幻想
fantastic	a. 奇妙的, 稀奇的, 空想的
fantasy	n. 幻想, 想象的产物 [医] 幻想
fare	n. 费用, 旅客, 食物 vi. 进展, 进步, 经营, 过活
farewell	n. 辞别, 再见, 再会 interj. 再会
farm	n. 农场, 农田 vt. 耕种 vi. 种田
farmers	n. 农民（farmer的复数）
farming	n. 农业, 耕作
farms	n. 农场；庄园（farm的复数形式）
fascinate	vt. 令人入神, 使着迷 vi. 入迷
fascinating	a. 迷人的, 吸引人的, 使人神魂颠倒的
fashion	n. 流行, 风尚, 时样 vt. 形成, 造, 作
fastidious	a. 难取悦的, 挑剔的, 苛求的
fatal	a. 致命的, 重大的, 命运注定的, 粗心的, 不幸的 [医] 致命的, 致死的
fatigue	n. 疲乏, 疲劳 vt. 使疲劳, 使心智衰弱 vi. 疲劳 a. 疲劳的
fatuous	a. 发呆的, 愚笨的
fault	n. 过错, 故障, 毛病 vt. 挑剔 vi. 产生断层, 弄错 [计] 故障
favor	n. 好意, 喜爱 vt. 赐予, 支持, 喜欢, 证实
favorite	n. 喜欢的事物, 幸运儿 a. 特别受喜爱的, 喜爱的, 宠爱的, 中意的
favour	n. 好感, 偏爱, 喜爱, 相信, 庇护, 赞同, 支持, 信赖, 善行, 恩惠, 徽章, 礼物 vt. 赞成, 帮助, 支持, 喜爱, 偏袒, 关切, 赐与, 给与, 有利于, 有助于, 像, 体恤
feasible	a. 能实行的, 可行的, 适宜的 [法] 可行的, 可执行的, 可完成的
feast	n. 宴会, 酒席, 享受, 节日 vt. 款待, 享乐, 请客 vi. 参加宴会, 尽情地吃, 享受
feat	n. 壮举, 功绩, 技艺表演 a. 灵巧的, 合适的, 整洁的
feature	n. 面孔的一部分(如眼、口等), 特征, 容貌, 特色, 特写 vt. 是...的特色, 特写, 放映 vi. 起重要作用 [计] 特性
features	n. 容貌；产品特点, 特征；嘴脸（feature的复数）
federation	n. 联邦, 联合, 联盟 [法] 联邦, 联盟, 联邦政府
fee	n. 费用, 小费, 封地, 所有权 vt. 付费给
feeble	a. 微弱的, 衰弱的, 无效的 [医] 无力的, 衰弱的
feedback	n. 反馈, 反应 [计] 反馈
feel	vt. 感觉, 觉得, 触摸, 以为 vi. 有知觉, 摸索, 同情 n. 感觉, 觉得, 触摸
fees	n. 规费；费用（fee的复数）
feet	pl. 脚 n. 尺
fellowship	n. 伙伴关系, 共同参与, 团体, 奖学金, 友谊 [经] 合伙关系, 研究员薪金, 研究员基金
female	n. 女性, 女人, 雌性动物 a. 女性的, 女子的
fend	vt. 击退, 保护, 供养
ferocious	a. 残忍的, 凶猛的, 可怕的
ferries	n. 渡船( ferry的名词复数 ); 渡口; 摆渡; 飞机渡运 v. 运送( ferry的第三人称单数 ); （乘渡船）渡过（河等）; 渡运飞机; 摆渡, 用（渡）船渡, （船）来往行驶
ferry	n. 渡船, 渡口 [法] 摆渡营业权, 轮渡
fertile	a. 可繁殖的, 肥沃的, 生产多的 [医] 能生育的
fervent	a. 热的, 炎热的, 热心的
fester	vi. 溃烂, 生脓 vt. 使溃烂 n. 脓疮, 溃烂
festival	a. 节日的, 喜庆的, 快乐的 n. 节日, 庆祝, 欢宴
fetch	n. 取得, 拿, 诡计, 魂 vt. 接来, 取来, 售得, 带来, 推出, 引出, 杀死, 吸引, 到达 vi. 取物, 前进 [计] 取
fetter	n. 脚镣, 羁绊, 束缚 vt. 束缚, 加脚镣
feud	n. 不和, 封地, 争执 vi. 长期不和, 擦亮
fever	n. 发烧, 发热, 热病 [医] 发热, 热
fiber	n. 纤维, 构造, 纤维制品 [化] 纤维
fibre	n. 纤维, 构造, 纤维制品 [化] 纤维
fickle	a. 变幻无常的, 浮燥的, 薄情的
fidelity	n. 忠实, 诚实, 忠诚, 保真度 [电] 逼真度
field	n. 领域, 田地, 场地, 战场, 场, 域 vt. 使...晒在场上, 使上场 a. 田间的, 野生的, 野外的, 田赛的 [计] 域, 字段
fierce	a. 凶猛的, 猛烈的, 热烈的, 暴躁的
fifth	num. 第五, 五分之一
figure	n. 数字, 价格, 图形, 形状 vt. 描绘, 表示, 演算, 认为 vi. 计算, 出现, 估计
figures	n. 图形, 图表；价格, 金额, 数字；规定动作；人物（figure的复数）
file	n. 档案, 公文箱, 文件夹, 文件, 卷宗, 锉刀 vi. 列队行进, 用锉刀做 vt. 归档, 申请, 锉, 琢磨 [计] 文件
film	n. 软片, 薄膜, 胶卷, 电影 vt. 覆以薄膜, 拍摄 vi. 生薄膜, 拍电影
filmed	v. 拍摄（复以薄膜）
filter	n. 滤波器, 过滤器, 滤光器, 过滤嘴, 去尘器 vt. 过滤, 渗透, 走漏 vi. 滤过, 渗入 [计] 过滤器, 筛选
filth	n. 污秽, 不洁, 猥亵 [法] 污秽, 污物, 淫猥
final	n. 期末考试, 结局, 决赛 a. 最后的, 终极的, 决定性的
finance	n. 财政, 财务 vt. 供给...经费, 负担经费 vi. 筹措资金
financial	a. 财政的, 金融的 [经] 财政的, 金融的, 财务的
finding	n. 发现, 发现物, 决定, 裁决 [法] 调查结果, 对事实的认定, 判定的要素
fine	n. 罚款, 罚金, 晴天, 精细 a. 好的, 晴朗的, 健康的, 细小的, 精细的 vt. 罚款, 精炼, 澄清 vi. 变清, 变细 adv. 很好 [计] 精细
fingers	n. 梳状剔除器；手指头, 指头（finger复数）
finite	a. 有限的, 有穷的, 限定的 n. 有限物
fire	n. 火, 炉火, 电炉, 火灾, 闪光体, 炮火, 热情 vt. 点燃, 烧制, 使发光, 激动, 放枪, 解雇 vi. 着火, 烧火, 开枪, 射击, 激动
firm	n. 公司, 商号 a. 坚定的, 坚强的, 牢固的, 结实的, 坚硬的, 坚挺的, 严格的, 确定的 vt. 使牢固, 使坚定 vi. 变稳固, 变坚实 adv. 稳固地
firms	n. 公司, 厂商（firm的复数）
first-aid	a. 急救的
fish	n. 鱼, 鱼肉, 鱼类, 接合板 vt. 钓, 钓鱼, 查出, 用接合板连接 vi. 捕鱼, 钓鱼, 用钩捞取, 摸索寻找
fishing	n. 钓鱼, 鱼业 a. 钓鱼的
fist	n. 拳头, 手 vt. 拳打, 握成拳, 紧握
fit	n. 适宜, 合身, 发作, 痉挛 a. 适宜的, 对的, 准备好的 vt. 适合, 安装, 使合身, 使适应, 使合格 vi. 适合, 符合, 合身 [计] 非特
fitness	n. 适合, 合宜, 合理, 恰当, 健康 [医] 适合性, 适应性
fitting	a. 适宜的 n. 试穿, 试衣, 装配, 装置
fixture	n. 固定(状态), 固定物, 设备 [计] 夹具
flabby	a. 软弱的, 没气力的, 不稳的, 松弛的
flag	n. 标志, 旗标, 旗子, 信号旗, 菖蒲 vt. 悬旗, 打旗号, 铺石板 vi. 无力地下垂 [计] 标志; 属性标记命令
flake	n. 小薄片, 扁薄的一层, 火星, 晒鱼架子 vt. 使成薄片 vi. 剥落
flame	n. 火焰, 火舌, 热情, 光辉 vt. 焚烧, 用火焰给...灭菌, 用火焰传送(信号), 点燃, 激动 vi. 燃烧, 爆发, 闪耀 [计] 无聊邮件, 无益邮件
flank	n. 侧面, 侧腹, 胁, 腰窝肉 vt. 攻击侧面, 守侧面 vi. 侧面与...相接
flap	n. 飘, 摆动, 拍打, 拍打声, 片状垂悬物 v. 拍打, 鼓翼而飞, 飘动
flare	n. 闪光, 闪耀 vi. 闪光, 闪耀 vt. 用发光信号发出, 使闪耀, 使张开
flash	n. 闪光, 闪现, 一瞬间 vi. 闪光, 闪现, 反射 vt. 使闪光, 反射
flask	n. 细颈瓶, 烧瓶, 小水瓶 [化] 瓶; 烧瓶
flat	a. 平坦的, 单调的, 无力的, 浅的, 萧条的, 干脆的, 无聊的 adv. 平直地, 断然地 n. 扁平物, 平面, 平地, 平原, 平板车 v. (使)变平
flats	n. 平原, 扁钢；低沼泽（flat的复数形式）
flatter	vt. 奉承, 阿谀, 使高兴 [机] 平面锤
flaunt	n. 炫耀, 飘扬 v. 炫耀, 飘扬
flavour	n. 味, 调味香料, 滋味, 香味, 气味, 风味, 情味, 情趣, 风韵 vt. 给...调味, 给...增添风趣, 加香料, 加味于
flaw	n. 缺点, 裂纹, 瑕疵, 一阵狂风 [化] 划痕; 裂缝; 裂纹
flee	vt. 逃避, 逃跑, 逃走 vi. 逃, 消失
fleet	n. 舰队, 港湾, 小河 a. 快速的, 敏捷的, 浅的, 短暂的 adv. 浅 vi. 疾驰, 飞逝, 掠过 vt. 消磨, 变换船(或船员)的位置
fleeting	a. 疾驰的, 短暂的, 飞逝的
flesh	n. 肉, 肉体, 肉欲, 人性, 亲属, 人类, 众生, 人体 vt. 以肉喂, 激起...的杀戳情绪, 使肥, 赋以血肉 vi. 长胖
flexible	a. 易曲的, 灵活的, 柔顺的, 能变形的, 可通融的 [医] 能屈的
flicker	n. 闪烁, 闪光, 颤动 vi. 闪动, 闪烁, 摇动, 扑动翅膀 vt. 使摇曳, 使闪烁
flight	n. 飞行, 射程, 逃走, 飞跃, 飞机航程, 班机, 迁徙, 飞逝 vi. 迁徙 vt. 射击(飞禽), 为(箭)装上羽毛, 使惊飞
fling	n. 投掷, 急冲, 嘲弄 vt. 投, 丢下, 抛弃, 使陷入, 挥动, 嘲笑, 扫视 vi. 猛冲
flip	vt. 掷, 弹, 轻击, 空翻 vi. 用指轻弹, 抽打, 蹦跳 n. 抛, 弹, 筋斗 a. 无礼的 [计] 翻转
flirt	n. 卖弄风骚的人, 急动, 急扔 vt. 忽然弹出, 轻快摆动, 挥动 vi. 调情, 玩弄, 摆动, 轻率地对待
float	n. 漂流物, 浮舟, 漂浮, 浮萍, 彩车 vi. 浮动, 飘动, 散播, 摇摆, 动摇, 浮动 vt. 使漂浮, 容纳, 淹没, 发行, 实行 [计] 浮动
flock	n. 兽群, 鸟群, 一群人, 大量, 棉束 vi. 成群而行, 聚集 vt. 用棉束填满
floors	n. 楼地面；地板；楼层；层数（floor的复数）
flour	n. 面粉, 粉沫, 碎粉 [医] 面粉, 麦粉
flourish	vi. 繁荣, 茂盛, 活跃, 手舞足蹈 vt. 挥舞, 夸耀 n. 挥舞, 炫耀, 茂盛, 兴旺, 华丽词藻
flourishment	n. 繁荣
flower	n. 花, 开花植物, 精华, 盛时 vi. 开花, 发育, 旺盛, 成熟 vt. 用花装饰, 使开花
flowers	[医] 花; 升华制成的药物; 月经
flu	n. 流感, 流行性感冒
fluctuate	vi. 变动, 起伏, 动摇 vt. 使波动, 使动摇
fluent	a. 流利的, 流畅的
fluff	n. 软毛, 柔毛, 绒毛, 错误, 无价值的东西 vi. 起毛, 变松, 出错 vt. 使起毛, 抖松, 念错
fluid	n. 液体, 分泌液, 流体 a. 流动的, 可改变的
flush	n. 流溢, 面红, 旺盛, 发烧, 惊飞的鸟, 同花牌 a. 丰足的, 齐平的, 满盈的, 泛滥的 adv. 齐平地, 直接地 vi. 脸发红, 奔涌, 旺盛, 惊飞 vt. 淹没, 冲洗, 使脸红, 使激动, 使齐平, 使惊飞
flutter	n. 摆动, 鼓翼, 烦扰 vi. 摆动, 鼓翼, 烦扰 vt. 拍(翅), 使焦急 [计] 颤动
flux	n. 流出, 涨潮, 变迁 vi. 熔化, 流出 vt. 使熔融 [计] 助焊剂
fly	n. 苍蝇, 两翼昆虫, 飞行 vi. 飞, 飞翔, 飘扬, 逃走 vt. 飞, 飞越, 使飘扬, 逃出 a. 敏捷的
flyover	n. 立交桥, 天桥, 立交马路
foam	n. 泡沫, 水沫, 泡沫材料 vi. 起泡沫, 吐白沫 vt. 使起泡沫
focus	n. 焦点, 焦距 vi. 聚焦, 注视 vt. 使聚焦, 调焦, 集中 [计] 焦点
foil	n. 箔, 烘托, 衬托 vt. 贴箔于, 衬托, 阻止, 挡开, 挫败
folder	n. 文件夹, 折纸机, 折叠式书本, 卷宗 [计] 文件夹
food	n. 食物, 养料 [医] 食物, 食品
foot	n. 脚, 步调, 英尺, 底部, 末尾, 步兵 vt. 走在...上, 给...换底, 支付 vi. 跳舞, 步行, 总计
forbes	n. 福布斯（美国出版及媒体集团）；福布斯（美国著名财经杂志）；福布斯（姓氏）
forecast	n. 预想, 预测, 预报 vt. 预想, 预测, 预报 [计] 趋势预测
foreign	a. 外国的, 外交的, 外省的, 外来的, 不相关的 [机] 外来的
foremost	a. 最初的, 最重要的 adv. 在最前
forerunner	n. 先驱, 前兆
foresee	vt. 预见, 预知
forest	n. 森林, 林区 vt. 植树于
forestry	n. 林学, 森林地 [法] 林地, 林学, 林业
forfeit	n. 没收物, 罚金, 丧失 vt. 没收, 丧失 a. 丧失了的
forge	n. 熔炉, 铁工厂 vt. 打制, 锻造, 伪造 vi. 锻造, 伪造
forgive	vt. 原谅, 宽恕, 免除 [法] 免除, 宽恕, 原谅
form	n. 形状, 形体, 类型, 方式, 表格, 形式 v. 形成, 排列, (使)组成 n. 表单 [计] 表单
formal	a. 正式的, 形式的, 礼仪的, 拘于礼节的, 拘谨的 n. 正式的社交活动
format	n. 开本, 版式, 形式, 格式 vt. 格式化 [计] 格式; DOS外部命令:对磁盘进行格式化
former	a. 从前的, 前者的 n. 起形成作用的人(或物), 模型, 样板
formidable	a. 巨大的, 优秀的, 可怕的, 艰难的
forms	n. 窗体；表单；表格（form的复数形式）
formula	n. 客套语, 公式, 准则 [计] 公式
formulate	vt. 用公式表示, 明确叙述, 制订 [机] 公式化, 公式表示
fort	n. 堡垒, 要塞, 易货站 vt. 设要塞保卫 vi. 设要塞
forte	n. 长处, 特长, 拿手, 优点
forthcoming	a. 即将来临的 n. 来临
fortify	vt. 设要塞于, 加强, 使坚强, 增加 vi. 筑防御工事
fortnight	n. 两星期
forum	n. 论坛, 公开讨论的广场, 法庭, 讨论会 [法] 讨论会, 专题讨论, 公共论坛
fossil	n. 化石, 古物 a. 化石的, 陈腐的, 守旧的
fossils	n. 化石( fossil的名词复数 ); 老顽固; 食古不化的人; 老古董（老人）
foster	a. 收养的, 养育的 vt. 养育, 抚育, 培养, 鼓励, 抱(希望)
foul	a. 污秽的, 邪恶的, 恶臭的, 肮脏的, 恶劣的, 淤塞的 vt. 弄脏, 妨害, 污蔑, 犯规, 淤塞 vi. 腐烂, 犯规, 缠结 adv. 违反规则地, 不正当地 n. 犯规, 缠绕
fountain	n. 水源, 源, 喷泉, 泉水, 本源 [医] 泉
foyer	n. 门厅, 入门大堂
fraction	n. 小部分, 破片, 分数 [医] 部分, 成分, 分散
fracture	n. 破碎, 骨折 v. (使)破碎, (使)破裂
fragile	a. 易碎的, 脆的 [医] 脆弱的, 脆的
fragment	n. 碎片, 破片, 片段 [计] 段落; 片段; 分段
fragrance	n. 芬芳, 香味
frail	a. 脆弱的, 虚弱的, 意志薄弱的 n. 少女, 少妇, 灯心草篓
framework	n. 结构, 骨架, 参照标准, 准则, 观点 [医] 构架组织
France	n. 法国
frantic	a. 狂乱的, 疯狂的
fraud	n. 欺骗, 欺诈, 诡计, 骗子 [经] 欺诈, 舞弊, 骗子
fraught	a. 含有...的, 伴着...的, 充满...的
freak	n. 畸形人, 畸形物, 不正常的事物, 反复无常 a. 奇异的, 反常的
freedom	n. 自由, 坦率, 特权 [法] 自由, 自主, 免除
freight	n. 船货, 运费, 货运 vt. 装货, 使充满, 以货运运送, 租(或出租)(船等)
French	n. 法国人, 法文, 法式 a. 法国的, 法国人的, 法语的
frequency	n. 频率, 频数 [计] 频率
frequent	a. 时常发生的, 频繁的, 快速的 vt. 时常来访, 常常聚集, 常与...交往
fret	n. 烦躁, 磨损, 焦急, 网状饰物 vi. 烦恼, 不满, 磨损 vt. 使烦恼, 腐蚀, 使磨损, 使起波纹
friction	n. 摩擦, 摩擦治疗, 不和 [医] 摩擦
Friday	n. 星期五
fridge	n. 电冰箱
fringe	n. 边缘, 端, 流苏, 穗, 初步 vt. 加穗于, 加饰边于 a. 边缘的, 附加的
frontier	n. 边界, 边境 [法] 国境, 边境, 边界
frost	n. 霜, 冰冻, 冷漠 vt. 覆着霜, 冻结, 结霜 vi. 受冻, 起霜
frown	n. 皱眉 vi. 皱眉头 vt. 皱眉表示
frugal	a. 节俭的, 朴素的
fruit	n. 水果, 果类, 结果 [医] 果实, 种实
fruition	n. 成就, 实现, 结果实
frustrate	vt. 挫败, 击败, 破坏 a. 无益的, 挫败的, 挫折的
fry	n. 油炸食物, 鱼苗 v. 油炸, 煎
fuel	n. 燃料, 木炭 vt. 加燃料, 供燃料 vi. 得到燃料
fulfil	vt. 实践, 履行, 实行, 完成, 结束, 满足 [经] 履行(契约), 满期
full-time	a. 全部时间的, 专任的
fume	n. 臭气, 烟, 激怒 vt. 熏 vi. 冒烟
function	n. 官能, 职务, 功能, 函数 vi. 活动, 运行, 行使职责 [计] 功能, 函数
fund-raising	(fund-raise 的现在分词) 募金
fundamental	n. 基本原理, 原则, 基波 a. 基本的, 重要的, 原音的
funeral	n. 葬礼, 出殡
funnel	n. 漏斗, 漏斗状的东西, 烟囱 [化] 漏斗
fur	n. 毛皮 vt. 以毛皮制作, 使生苔, 使生水垢 vi. 生苔, 积水垢
furious	a. 狂怒的, 激烈的, 吵闹的
furnace	n. 火炉, 熔炉, 考验 vt. 在炉中烧
furnish	vt. 供给, 提供, 装设 [化] 供应; 供给; 配料
furniture	n. 家具, 帆具
further	a. 更远的, 此外的, 更多的 vt. 促进, 增进, 助长 adv. 更进一步地, 更远地, 此外
fury	n. 愤怒, 狂暴, 狂怒的人 [医] 狂乱, 狂暴, 狂怒
fuse	n. 保险丝, 导火线 v. 熔化, 融合
fusion	n. 熔合物, 结合, 熔合 [化] 熔融; 熔化; 聚变
fuss	n. 大惊小怪, 小题大作, 忙乱 vi. 无事自扰, 焦急, 焦燥, 忙乱 vt. 使激动, 使烦燥
future	n. 未来, 将来 a. 将来的, 未来的
gaily	adv. 华丽地, 欢乐地
galaxy	n. 银河, 星系, 一群(显赫的人物) [电] 银河系
gale	n. 狂风, 大风, 定期租金 [经] 地租, 年金
gallery	n. 走廊, 最高楼座, 画廊, 收集, 图库 [计] 图库
gamble	n. 赌博, 冒险 v. 赌博, 孤注一掷
gang	n. 队, 群, 帮 vi. 成群结队, 结成一伙 vt. 使成群结队
gaol	n. 监禁, 监狱 vt. 监禁
gap	n. 缝隙, 缺口, 间断, 间距, 通用汇编程序 vt. 打开缺口, 造成缝隙 vi. 豁开 [计] 通用汇编程序, 图形应用程序, 间距
gape	n. 裂口, 张嘴, 打哈欠 vi. 裂开, 张嘴, 打哈欠
garage	n. 车库, 汽车修理厂, 机库 vt. 把车送入修车场
garbage	n. 垃圾, 废物 [计] 无用信息
garden	n. 花园, 果园, 菜园 vi. 栽培花木 vt. 造园 a. 花园的, 普通的
garment	n. 衣服, 衣装, 外表
gasp	n. 喘气 vi. 喘气, 喘息, 渴望 vt. 气喘吁吁地说
gaudy	a. 俗丽的, 华而不实的 n. 盛大宴会
gauge	n. 标准度量, 计量器 vt. 精确计量, 估计 [计] 线规
gaunt	a. 瘦削的, 憔悴的, 荒凉的
gear	n. 齿轮, 工具 vt. 以齿轮连起, 开动, 使适应, 安排 vi. 连接上, 适合
gender	n. 性 vt. 产生
gene	n. 基因 [化] 基因(遗传因子)
general	n. 一般, 将军, 大体 a. 全面的, 大体的, 总的, 一般的, 普遍的 n. 常规 [计] 常规
generalize	vt. 一般化, 概括, 推广 vi. 形成概念, 笼统讲
generate	vt. 产生, 发生, 导致 [电] 产生
generic	a. 属类的, 一般的 [计] 一般的
generous	a. 慷慨的, 有雅量的, 大量的, 丰富的
genetic	a. 创始的, 遗传的, 起源的, 遗传学的 [医] 生殖的, 遗传的
genial	a. 和蔼的, 亲切的, 友善的 [医] 颏的
genius	n. 天才, 天赋, 精神, 神魔 [医] 特征
gentle	a. 温和的, 文雅的
genuine	a. 真正的, 真实的, 诚恳的 [医] 真性的
geographic	a. 地理(学)的, 地区(性)的
geography	n. 地理学, 地理 [医] 地理
geology	n. 地质学, 地质情况
geometry	n. 几何学 [机] 几何学
germ	n. 细菌, 种子, 生殖细胞, 根源 [医] 芽胞, 胚, 胚芽, 病菌
German	n. 德国人, 德语 a. 德国的, 德国人的, 德国语的, 同父母的
Germany	n. 德国
gesture	n. 手势, 姿态 vi. 作手势, 作姿态
get	vt. 得到, 获得, 变成, 使得, 收获, 接通, 抓住, 染上 vi. 到达, 成为, 变得 n. (网球等)救球, 生殖, 幼兽 [计] 取得指令, 获取文件
ghastly	a. 可怕的, 惨白的, 极坏的 adv. 可怖地, 惨白地
gigantic	a. 巨人般的, 巨大的
giggle	v. 吃吃地笑, 咯咯地笑 n. 咯咯笑, 傻笑
girlfriend	n. 女朋友
gist	n. 要点, 要旨, 依据 [法] 依据, 要旨, 要点
give	n. 弹性, 适应性 vt. 给, 授予, 供给, 产生, 发表, 付出, 献出, 让出 vi. 捐赠, 支持不住, 让步
glacier	n. 冰川
glamour	n. 魅力, 迷人的美, 魔法 vt. 迷惑
gland	n. 腺, 密封套 [化] 衬片; 密封垫
glare	n. 闪耀光, 刺眼 vi. 发眩光, 瞪视 vt. 瞪眼表示
glass	n. 玻璃, 玻璃杯, 透镜 vt. 装玻璃于, 反射, 反映 vi. 成玻璃状
gleam	n. 光束, 微光, 反光 vi. 闪烁, 隐约地闪现 vt. 使发微光, 使闪烁
glide	n. 滑动, 滑过, 流水 vi. 滑动, 滑翔, 溜走, 流逝 vt. 使滑动
glimmer	n. 一丝光线, 微光, 少许 vi. 发微光
glimpse	n. 一瞥, 一闪 vi. 投以一瞥, 闪烁不定 vt. 瞥见
glitter	n. 灿烂, 闪烁, 辉耀 vi. 灿烂, 闪烁, 辉耀
global	a. 通用的, 全球的, 球形的, 综合的, 普遍的 [计] 共用
gloomy	a. 抑沉的, 忧闷的, 黑暗的, 悲观的
glorious	a. 光荣的
gloss	n. 光彩, 假象, 注释 vt. 使光彩, 掩盖, 上光于, 注释, 曲解 vi. 发光, 作注释
glossary	n. 专业词典, 术语集, 词表 [计] 图文集
glow	n. 赤热, 光辉, 热情, 热烈, 红光 vi. 发红光, 红光焕发, 发热, 洋溢, 激动
glue	n. 胶, 粘性物 vt. 粘合, 胶合
go	vi. 去, 走, 达到, 运转, 查阅, 消失, 结束, 放弃, 花费, 流传, 趋于, 打算, 剩下 vt. 以...打赌, 对付, 忍受, 出产, 为被捕者出(保释金) n. 去, 尝试, 进行
goad	n. 赶牛棒, 激励, 刺激 vt. 用刺棒驱赶, 激励, 刺激, 唆使, 煽动
goal	n. 目标, 终点, 得分, 球门, 守门员 vi. 攻门, 射门得分
goals	n. 目标, 目的；进球, 射中次数
gold	n. 黄金, 钱财, 金块, 金色, 宝贵 a. 金的, 似金的, 金色的, 金制的
golf	n. 高尔夫球 vi. 打高尔夫球
good	n. 善行, 好处, 利益 a. 好的, 优良的, 上等的, 愉快的, 有益的, 好心的, 慈善的, 虔诚的
goods	n. 货物 [经] 货物, 商品, 动产
gorgeous	a. 华丽的, 灿烂的
gossip	n. 闲聊, 随笔, 流言, 爱讲闲话的人 vi. 说闲话, 闲聊
government	n. 政府, 内阁 [经] 政府, 政治, 政体
governments	n. 政权；政府；可转让政府证券（government的复数）
gown	n. 睡衣, 法衣, 大学全体师生 vt. 使穿睡衣
grab	n. 抓握, 掠夺, 强占, 东方沿岸帆船 vi. 抓取, 抢去 vt. 攫取, 捕获, 霸占
grace	n. 优雅, 风度, 慈悲, 恩惠, 体面, 赦免, 恩典, 谢恩祷告 vt. 使优美
gracious	a. 亲切的, 慈善的
grade	n. 等级, 年级, 阶段, 成绩, 程度, 坡度, 斜坡 vt. 分等, 分级, 评分 vi. 属于某等级, 逐渐变化
gradual	a. 逐渐的, 渐增的 n. 弥撒升阶圣歌
graduates	n. <美>毕业生( graduate的名词复数 ); <英>大学毕业生; （已经取得学士学位正在攻读高级学位的）研究生; 量筒 v. 渐变( graduate的第三人称单数 ); 渐渐变为（与into连用）; 渐渐消逝（与away连用）; 取得资格（与as连用）
grain	n. 谷粒, 颗粒, 谷类, 纹理, 本质 v. (使)成谷粒
grammar	n. 语法学, 入门书 [计] 语法检查
granary	n. 谷仓, 谷物仓, 主要来源, 主要贮藏所
grand	a. 庄重的, 壮观的, 显赫的, 重大的, 最高的, 雄伟的, 宏大的, 豪华的, 傲慢的 [法] 重大的, 主要的, 伟大的
grant	n. 授予, 授予物, 允许 vt. 允许, 承认, 授与 [计] 授权命令
grants	[经] 补助金, 拨款, 津贴
granular	a. 颗粒的, 粒状的 [医] 粒状的, 颗粒状的
graph	n. 曲线图, 图表, 图形 [计] 图形
graphic	a. 生动的, 轮廓分明的, 绘画似的, 图解的 [计] 图形的
grass	n. 草, 草原, 牧场 [医] 草, 禾本
grate	n. 炉格, 炉篦, 炉栅, 火炉, 壁炉, 格栅 vt. 装格栅于, 磨擦, 轧碎, 磨碎, 使焦急, 触怒, 使人烦躁, 刺激, 激怒 vt.vi. 擦响, 发出刺耳的尖厉声
gratitude	n. 感激之情
gratuity	n. 小费, 赠物, 赏钱 [经] 小帐, 赏金, 退职金
grave	n. 墓穴, 坟墓, 终结, 死亡 a. 庄重的, 严肃的, 重大的, 低沉的 vt. 雕刻
gravel	n. 砂砾, 碎石 [医] 沙砾, 尿沙
gravity	n. 地心引力, 重力 [化] 重力
graze	n. 吃草, 放牧, 擦伤, 轻擦 v. (使)吃草, 放牧, 轻擦, 擦伤
grease	n. 脂肪, 兽脂, 油脂, 贿赂 vt. 涂脂于, 贿赂
Greece	n. 希腊
greedy	a. 贪婪的, 贪得的, 贪吃的
green	n. 绿色, 绿色颜料 a. 绿色的, 未成熟的, 新鲜的, 青春的, 无经验的, 脸色发青的
grid	n. 格子, 栅格 [计] 网格
grief	n. 伤心, 忧愁, 悲痛, 不幸, 灾难
grieve	vt. 使悲伤 vi. 悲痛, 伤心
grill	n. 烤架, 铁格子, 烤肉 v. 烧, 烤, 严加盘问, 给...装栅栏
grim	a. 冷酷的, 坚强的, 残忍的, 可怕的, 讨厌的
grin	n. 露齿笑 v. 露齿而笑
grind	n. 磨, 碾, 苦差, 摩擦声, 用功的学生 vt. 磨擦, 磨碎, 磨光, 折磨, 压榨 vi. 磨, 磨碎, 苦干
grip	n. 紧握, 柄, 握力, 握手方式, 手提包, 掌握, 支配, 控制 vt. 抓紧, 抱住, 吸住, 掌握 vi. 握牢, 有吸引力
grit	n. 砂砾, 粗砂石 vt. 覆以砂砾, 咬牙切齿地说 vi. 摩擦作声
groan	n. 呻吟, 叹息 vi. 呻吟, 抱怨, 受压迫 vt. 呻吟地说
grope	v. 摸索 n. 摸索
gross	n. 总数, 总量 a. 总共的, 未打折扣的, 恶劣的, 粗野的 vt. 总共收入
ground	n. 土地, 战场, 场地, 地面, 范围 a. 土地的, 地面上的 vt. 放在地上, 使搁浅, 打基础, 给...以训练 vi. 搁浅, 落地, 根据, 基于 a. 磨过的 grind的过去式和过去分词
group	n. 团体, 组, 团, 群 v. 聚合, 成群 [计] 创建组; 组, 用户组
groups	n. 群组, 组；用户组；团体（group的复数形式）
growl	n. 吠声, 咆哮声 v. 怒吠, 咆哮, 吼
growth	n. 生长, 栽培, 增长 [计] 等比级数
grudge	n. 怨恨, 恶意 vt. 怀恨, 嫉妒, 吝惜
grumble	n. 怨言, 满腹牢骚 vi. 抱怨, 发牢骚, 发隆隆声 vt. 抱怨
guarantee	n. 担保, 抵押品, 保证书 vt. 保证, 担保
guardian	n. 看守者, 监护人, 保护人 a. 保护的
guest	n. 客人, 来宾, 旅客 [化] 客体
guests	n. 客人；来宾（guest的复数）
guidance	n. 指导, 领导 [医] 导
guide	n. 引导者, 导游, 指南, 路标 vt. 指导, 支配, 管理, 带领, 操纵 vi. 任向导 [计] 辅助线
guideline	n. 指导路线, 方针, 指标 [经] 指导路线, 方针, 准则
guild	n. 团体, 协会, 行业协会 [经] 同业公会
guitar	n. 吉他
gush	n. 涌出, 滔滔不绝地讲话 v. 涌出, 迸出, 滔滔不绝的讲话
gust	n. 突然一阵, 趣味, 爱好
guy	n. 家伙, 支索 vt. 用支索撑住, 取笑, 嘲弄 vi. 逃跑
gym	n. +体育馆, 体育训练, 体育课, 体操
gymnasium	n. 健身房, 体育馆 [医] 体育馆, 健身室, 运动场
habit	n. 习惯, 嗜好, 习性 vt. 使穿衣
habits	n. 习性；习惯（habit的复数）
hail	n. 冰雹, 致敬, 欢呼, 招呼 vt. 向...欢呼, 致敬, 招呼, 使象下雹样落下 vi. 招呼, 下雹 interj. 万岁, 欢迎
hall	n. 门厅, 走廊, 会堂
halt	n. 停止, 立定, 休息 vt. 使停止, 使立定 vi. 立定, 停止, 蹒跚, 踌躇, 有缺点 [计] 停止
hamper	n. 食篮, 阻碍物, 食盒 vt. 阻碍, 使困累, 妨碍, 牵制
hand	n. 手, 爪, 指针, 掌握, 协助, 人手, 手艺, 手迹, 支配, 插手 vt. 交给, 支持, 搀扶
handball	n. 墙手球, 墙手球运动
handbook	n. 手册 [计] 手册
handicap	n. 障碍, 困难, 不利条件 vt. 加障碍于, 妨碍
handling	n. 处理 a. 操作的
handout	n. 施舍物, 救济品, 分发的印刷品资料, 广告物品
handsome	a. 英俊的, 大方的, 慷慨的, 相当可观的, 美观的, 灵敏的
handy	a. 便利的, 敏捷的, 容易取得的 [化] 便于使用的; 易操作的
hang	n. 悬挂, 诀窍, 意义 vt. 悬挂, 附着, 装饰, 垂下, 踌躇, 绞死, 使悬而未决 vi. 悬着, 垂下, 被绞死, 悬而不决
haphazard	n. 偶然性, 偶然事件 a. 无计划的, 偶然的, 随便的 adv. 偶然地
harass	vt. 使困扰, 使烦恼, 折磨
harassment	n. 困扰, 烦扰, 烦恼 [法] 折磨, 骚扰, 侵扰
harbor	n. 港, 避难所 v. 庇护, 藏匿, (使)入港停泊
harbour	n. 港, 避难所 v. 庇护, 藏匿, (使)入港停泊
hard	a. 坚硬的, 硬的, 难的, 艰苦的, 困难的, 坚固的, 猛烈的, 艰难的, 结实的, 确实的 adv. 坚硬地, 努力地, 辛苦地, 接近地, 猛烈地, 牢固地
hard-working	(hard-work 的现在分词) 努力工作；[劳经] 繁重的工作
hardware	n. 硬件, 五金器具, 零件 [计] 硬件
hardy	a. 难的, 艰苦的, 坚硬的, 勇敢的 adv. 努力地, 辛苦地, 坚硬地
harmful	a. 有害的, 伤害的
harmony	n. 协调, 和睦, 调和 [电] 和声学
harness	n. 马具, 挽具状带子, 甲胄 vt. 给...上挽具, 驾驭, 披上甲胄, 利用...以产生动力
harsh	a. 粗糙的, 刺耳的, 严厉的 [法] 粗糙的, 严厉的, 苛刻的
haste	n. 匆忙, 急忙
hasty	a. 匆匆的, 轻率的, 性怠的
hat	n. 帽子 vt. 给...戴帽子
hatch	n. 孵化, 舱口 vt. 孵, 孵出, 策划 vi. 孵化
hats	abbr. 转换终端应用程序（Host Access Transformation Services）
haul	n. 用力拖拉, 拖运, 强拉, 捕获量, 拖运距离 vi. 拖, 拉, 改变方向, 改变主意 vt. 拖拉, 拖运
haunt	n. 常到的地方, 生息地 vt. 常到, 出没于, 萦绕于 vi. 出没, 作祟
haven	n. 港, 避难所, 安息所 vt. 安置...于港中, 庇护, 入港
havoc	n. 大破坏, 蹂躏 vt. 严重破坏
hawk	n. 鹰, 掠夺者, 鹰派成员 vi. 放鹰行猎, 像鹰一般地袭击, 清嗓, 咳嗽 vt. 捕捉, 咳出, 兜售, 叫卖, 散播
hazard	n. 冒险, 危险, 机会 vt. 冒...的危险, 赌运气, 使冒危险 [计] 相关危险; 冒险
hazardous	a. 危险的, 冒险的, 碰运气的 [法] 危险的, 冒险的, 碰运气的
headache	n. 头痛, 令人头痛之事 [医] 头痛
heading	n. 标题, 起始字, 方向 [计] 上标题
headmaster	n. (中小学)校长, 监工
headstrong	a. 顽固的, 刚愎的, 任性的
heal	vi. 痊愈 vt. 使复原, 使和解, 治愈
health	n. 健康, 卫生, 蓬勃, 健康状态 [医] 健康
healthcare	n. 医疗保健；卫生保健；健康护理, 健康服务
heap	n. 堆, 许多, 累积 vt. 堆积, 装满 [计] 堆
hearing	n. 听, 听觉, 听讯 [医] 听, 听觉
heart	n. 心, 心脏, 中心, 内心, 感情, 精神, 心情, 宝贝儿 vt. 鼓励
heartbeat	n. 心跳
heater	n. 加热器, 灯丝, 加热工 [化] 加热器
heave	n. 举, 抛, 起伏, 鼓起 vt. 用力举起, 使举起, 使鼓起 vi. 抛出, 起伏, 喘息, 凸起
heavy	a. 重的, 巨大的, 沉重的, 笨重的, 过度的 adv. 沉重地 n. 重物, 严肃角色
hectic	a. 脸上发红, 发热的, 潮热的, 肺病的 n. 脸红, 潮热病人
hedge	n. 树篱, 障碍, 套头交易 vt. 用树篱围, 套期保值, 妨碍, 两面下注以防...的损失 vi. 筑树篱, 躲闪, 两面下注以防损失 a. 树篱的, 偷偷摸摸的
height	n. 高度, 海拔, 高地, 顶点 [化] 高度
heighten	vt. 增高, 提高, 加强 vi. 升高, 变大
heir	n. 继承人, 嗣子, 后嗣 [法] 继承人, 后嗣
helicopter	n. 直升机 vt. 由直升机运送 vi. 乘直升机
hell	n. 地狱, 邪恶势力, 苦境, 阴间, 毁坏, 训斥 vi. 狂饮, 飞驰
helmet	n. 钢盔, 盔, 防护帽 vt. 给...戴头盔
helpline	n. 热线服务电话
hemisphere	n. 半球, 地球的半面, 大脑半球 [医] 半球
hence	adv. 因此, 从此
henceforth	adv. 自此以后, 今后
hens	n. 母鸡( hen的名词复数 ); 雌禽
herb	n. 药草, 香草 [医] 草, 草本, 草药
herd	n. 兽群, 人群, 牧人 vt. 群集, 使成群, 放牧 vi. 聚在一起
hereditary	a. 世袭的, 遗传的 [医] 遗传的
heritage	n. 遗产, 祖先遗留物, 继承物 [医] 遗传性
hero	n. 英雄, 超越常人者, 男主角
heroine	n. 巾帼英雄, 烈妇, 女主角 [化] 海洛因; 二醋吗啡; 二乙酰吗啡
hierarchy	n. 等级制度, 僧侣统治, 等级体系 [计] 分级结构; 分层结构; 新闻组, 新闻组分层
high-rise	a. 有多层的, 高楼的 n. 高楼, 大厦
higher	[经] 上扬
highlight	n. 加亮区, 精彩场面 vt. 加亮, 使显著, 以强光照射, 突出 [计] 突出
hijack	vt. 抢劫, 劫持, 敲诈 [法] 挡路抢劫, 抢劫, 绑架
hike	n. 徒步旅行, 远足, 涨价, 提高 vi. 步行, 徒步旅行, 上升 vt. 使高涨, 拉起
hilarious	a. 喜不自禁的, 欢闹的, 引人发笑的
hinder	a. 后面的 v. 阻碍, 打扰
hinge	n. 铰链, 关键, 枢纽 vt. 装铰链 vi. 靠铰链移动, 依...而转移
hint	n. 暗示, 提示 v. 暗示, 示意
hints	n. 暗示, 提示（hint的复数形式）
hiring	[法] 租用, 雇用
historian	n. 历史学家, 记事者
historic	a. 历史上著名的, 有历史性的
historical	a. 历史的, 史实的, 历史上的 [法] 历史性的
history	n. 历史, 过去, 经历, 发展过程, 历史学, 过去的事, 历史记录 [计] 历史记录
hit	n. 打击, 打, 冲撞, 讽刺 vt. 打, 打击, 碰撞, 打中, 袭击, 偶然碰上 vi. 打, 打中, 打击, 碰撞, 偶然碰上 [计] 击中; 找到; 瞬时打扰
hitchhike	vi. 搭便车 vt. 要求(搭便车)
hitherto	adv. 迄今, 至今
hits	n. 击打；网页点击数；采样数（hit的复数）
hobbies	n. 嗜好；兴趣爱好；燕隼；[英方]小马（hobby的复数）
hobby	n. 嗜好, 癖好, 爱好
hoist	n. 升高, 起重机, 推动 v. 升起, 升高, 举起
hold	n. 把握, 把持力, 柄, 控制, 掌握, 监禁 vt. 保存, 握住, 拿住, 占据, 持有, 拥有 vi. 支持, 持续, 有效 n. 保留 [计] 保留
holiday	n. 假日, 假期, 节日 vi. 度假
holocaust	n. 大屠杀, 大火灾, 毁灭, 大规模烧杀
homework	n. 家庭作业, 家里做的工作 [经] 家庭作业
homogeneous	a. 同种的, 同质的, 齐性的 [医] 同种的, 纯一的, 同质的, 均匀的
hop	n. 单脚跳, 跳跃, 舞会, 飞行 vi. 单脚跳, 跳跃 vt. 跃过, 跳上, 加蛇麻子于, 服麻醉药 [计] 跳跃式传输
horizon	n. 地平线, 眼界, (天)视地平
horrible	a. 可怕的, 遭透的, 极讨厌的
horse	n. 马, 骑兵, 脚架 vi. 骑马, 取笑 vt. 使骑马, 系马于
horses	n. 马；马匹（horse的复数形式）
horticulture	n. 园艺
hose	n. 水管, 橡皮软管, 长统袜 vt. 用水管浇
hospital	n. 医院 [医] 医院
hospitality	n. 款待, 亲切, 殷勤
host	n. 主人, 旅馆老板, 节目主持人 vt. 当主人招待, 作...节目主持人 [计] 主机, 宿主机
hostage	n. 人质, 抵押品 [经] 人质, 抵押品
hostile	a. 敌人的, 怀敌意的, 敌对的 n. 敌对分子
hotel	n. 旅馆, 客栈
hound	n. 猎犬 vt. 带猎犬狩猎, 追捕, 激励, 使追逐
house	n. 房子, 住宅, 机构, 议院, 家族, 家庭 vt. 给...房子住, 收藏 vi. 住, 躲藏
households	n. 同住在一所房子里的人, 一家人, 户( household的名词复数 )
housekeeping	n. 家事, 家政, 持家 [计] 内务处理
housing	n. 遮盖, 住房供给, 居留(处), 房屋, 装饰 [化] 外壳
hover	vi. 盘旋, 翱翔, 徘徊 vt. 孵 n. 翱翔
howl	n. 嗥叫, 吠声, 号叫 vi. 狂吠, 咆哮, 呼啸 vt. 对...吼叫, 狂喊着说
hubbub	n. 吵闹声, 叫嚷声, 混乱
huddle	n. 杂乱一团, 混乱, 拥挤 vt. 把...挤在一起, 乱堆, 草率了事, 蜷曲 vi. 挤作一团, 蜷缩
hug	n. 紧抱, 拥抱 vt. 紧抱, 坚持, 使沾沾自喜
hum	n. 嗡嗡声, 哼声, 杂声 vi. 发低哼声 vt. 哼, 用哼声表示 interj. 哼, 嗯
human	n. 人, 人类 a. 人类的, 似人类的, 人性的, 有同情心的
humanity	n. 人性, 人类, 博爱
humans	n. 人类（human的复数形式）
humble	a. 低下的, 谦逊的, 粗陋的 vt. 使...卑下, 降低...地位, 贬抑
humdrum	a. 平凡的, 单调的, 令人厌烦的 n. 平凡, 单调, 无聊 vi. 单调令味地进行
humidity	n. 湿气, 潮湿, 湿度 [计] 湿度
humiliate	vt. 使丢脸, 使蒙羞, 屈辱
hunt	n. 狩猎, 追捕, 搜寻, 猎区 vt. 狩猎, 打猎, 搜索 vi. 打猎, 猎食, 搜寻
hunting	n. 狩猎, 猎狐, 探求 [计] 寻找平衡; 寻找
hurl	n. 用力的投掷 vt. 用力投掷, 发射, 愤慨地说出, 丢下 vi. 猛投, 猛掷
hurricane	n. 飓风, 暴风, 暴风雨
hydrogen	n. 氢 [化] 氢H-2
hygiene	n. 卫生保健, 卫生学, 保健法 [医] 卫生, 卫生学
hypothesis	n. 假设 [化] 假设
hysterical	a. 歇斯底里的, 异常兴奋的 [医] 癔病的, 歇斯底里的
ice	n. 冰, 冰淇淋, 糖衣, 冷若冰霜, 矜持, 贿赂 vt. 使结冰, 冰镇, 覆以糖衣 vi. 结冰
idea	n. 主意, 办法, 理想, 思想, 概念, 意见 [医] 观念, 思想
ideal	n. 理想, 典范, 观念, 思想, 最后目标 a. 理想的, 完美的, 空想的, 观念的, 唯心论的
ideas	abbr. 工业设计优秀奖
identical	a. 同一的, 恒等的, 完全相同的 [医] 同一的, 同等的
identification	n. 识别, 身份证明, 认同 [化] 鉴定; 鉴别; 鉴别法; 认证
identify	vt. 识别, 认为...等同于, 确定, 使参与 vi. 一致, 认同
identities	n. 身份( identity的名词复数 ); 同一性; 个性; 同一人
identity	n. 身份, 相同, 一致, 特性, 恒等式 [计] (打)标记, 标识
ideology	n. 思想体系, 意识形态, 观念学, 空论 [医] 观念学, 观念形态
idiom	n. 习语, 成语, 惯用语法, 方言
idiot	n. 白痴, 极蠢之人 [医] 白痴者, 痴子
idle	a. 懒惰的, 闲散的, 停顿的, 空闲的, 无用的 vi. 无所事事, 闲散, 浪费, 空转 vt. 虚度, 使闲散, 使空转 n. 空转, 空闲时间 [计] 空闲时间
ignite	vt. 点燃, 使灼热, 使兴奋
ignorance	n. 无知, 愚味 [法] 无知, 不知情, 愚昧
illegal	a. 违法的, 不合规定的 [经] 非法的, 犯规的
illiterate	n. 文盲 a. 目不识丁的, 没受教育的
illness	n. 疾病, 恶意 [医] 病
illuminate	vt. 照明, 用灯装饰, 阐明, 说明, 使灿烂 vi. 照亮, 用灯装饰
illusion	n. 幻影, 错觉, 幻想 [医] 错觉
illustrate	vt. 举例说明, 作图解, 阐明 vi. 举例说明
image	n. 影像, 肖像, 想象, 图像, 形象, 翻版 vt. 作...的像, 反映, 想象, 象征 n. 图像 [计] 图象
imaginative	a. 想像的, 虚构的
imitate	vt. 模仿, 效法, 冒充, 仿造
imitation	n. 模仿, 效法, 冒充, 赝品 [医] 模仿, 仿制, 仿制品
immense	a. 极广大的, 无边的, 非常好的
immerse	vt. 沉浸, 使陷入 [医] 浸[入]
immigrant	n. 移民 a. 移入的, 移民的
imminent	a. 即将来临的, 逼近的
immune	a. 免疫的, 免除的, 不受影响的 n. 免疫者
impact	n. 冲击, 冲突, 影响, 效果 vt. 挤入, 撞击, 压紧, 对...发生影响
impair	vt. 损害, 减少, 削弱 [法] 损害, 伤害, 减少
impart	vt. 给予, 传授, 告知
impede	vt. 妨碍, 阻碍, 阻止
imperative	n. 命令, 必要的事, 规则, 祈使语气 a. 命令式的, 急需的, 势在必行的, 强制的
imperial	a. 帝王的, 宗主国的, 至尊的, 壮丽的 n. 特等品
impetus	n. 动力, 推动力, 动量 [医] 冲动, 动能, 起始(病)
implement	n. 工具, 器具, 手段 vt. 实现, 使生效, 执行
implicit	a. 暗示的, 含蓄的, 固有的, 绝对的 [经] 不讲明的, 含蓄的
important	a. 重要的, 有地位的, 大量的, 显要的, 自负的 [计] 要点
imports	n. 进口商品；进口总额（import的复数）
impose	vt. 征(税), 把...强加于, 以...欺骗 vi. 利用, 欺骗, 施加影响
imposing	a. 令人难忘的, 壮丽的, 威风的
impossible	a. 不可能的, 难以置信的, 令人无法忍受的
impressive	a. 给人深刻印象的, 威严的
impromptu	n. 即席演出, 即兴曲 a. 即席的 adv. 即席
improvement	n. 进步, 改善, 利用 [医] 改善, 好转, 进步
improvise	vt. 即席创作, 临时做
impulse	n. 冲动, 驱使, 刺激, 推动, 冲力, 建议, 脉冲 vt. 推动
in	prep. 在...期间, 在...之内, 处于...之中, 从事于, 按照, 穿着 adv. 进入, 朝里, 在里面, 在屋里 a. 在里面的, 在朝的 n. 执政者, 交情
inability	n. 无能, 无力
inaccurate	a. 错误的, 不准确的 [化] 不精确
inadequate	a. 不充分的, 不适当的 [法] 不充分的, 不适当的
inapt	a. 不适当的, 不熟练的
inaugurate	vt. 开始, 举行...就职典礼
incentive	n. 动机 a. 激励的
incidence	n. 发生, 发生率, 影响, 负担者, 入射, 倾角 [医] 入射, 发生率, 发生数
incidentally	adv. 伴随地, 偶然, 顺便
incipient	a. 起初的, 发端的, 初期的 [医] 初发的, 初期的
incite	vt. 刺激, 激励, 引诱 [法] 鼓动, 煽动
inclination	n. 倾向, 趋向, 倾斜度, 点头 [化] 倾角
incline	n. 倾斜, 斜坡, 斜面 vt. 使倾向于, 使倾斜 vi. 倾向, 倾斜, 爱好, 易于
inclusive	a. 包含的, 包括的
incoming	a. 进来的, 刚开始的, 新来的 n. 进来
incongruous	a. 不协调的, 不一致的, 不合适的
incorporate	a. 合并的, 组成公司的, 一体化的 vt. 吸收, 合并, 使组成公司, 体现 vi. 合并, 混合, 组成公司
incredible	a. 难以置信的
increment	n. 增加, 增值, 盈余 [计] 增量
incur	vt. 招致, 蒙受, 遭遇 [经] 招致, 蒙受, 担负
indefinite	a. 模糊的, 不确定的, 无限的 [法] 不确定的, 无限制的
indelible	a. 难以消除的, 不能拭除的, 难忘的
indemnity	n. 赔偿, 保障, 补偿, 赦免, 保护 [经] 赔偿, 补偿, 赔偿金
independence	n. 独立, 自立, 自主 [医] 自主性, 独立性
index	n. 索引, 指针, 指数, 指标 vt. 编入索引中, 指出 vi. 做索引 [计] 下标; 附标; 变址; 索引; 编索引
Indian	n. 印度人, 印第安人, 印第安语 a. 印度的, 印度群岛的, 印第安语的
indicative	a. 指示的, 象征的, 表示...的 [经] 指标的
indicator	n. 指示器, 指示剂, 指标 [计] 指示器
indifferent	a. 漠不关心的, 无重要性的, 中立的 [医] 中性的, 无作用的, 无亲和力的, 淡漠的
indigenous	a. 本土的, 国产的, 固有的 [医] 原产的, 本土的
indignant	a. 愤怒的, 愤慨的
indispensable	n. 不可缺少之物 a. 不可缺少的, 责无旁贷的, 绝对必要的
individual	n. 人, 个人, 个体 a. 个别的, 个人的, 独特的
induce	vt. 引诱, 招致, 归纳出, 感应 [医] 诱导, 感应
indulge	vt. 纵情于, 使高兴, 放任, 迁就 vi. 沉溺
industrial	a. 工业的, 供工业用的, 工业高度发展的, 产业的 n. 工业工人, 工业股票
industry	n. 勤劳, 工业, 企业, 产业, 有组织的劳动 [经] 工业, 实业
inept	a. 不适当的, 不理智的, 笨拙的 [法] 不称职者, 无能的, 不符要求的
inert	a. 惰性的, 迟钝的, 无活力的, 呆滞的 [医] 惰性的, 无作用的, 无效的
inertia	n. 惯性, 惰性, 迟钝 [化] 惯性
inevitable	a. 不可避免的, 必然的 [法] 不可避免的, 无法规避的, 必然的
infant	n. 婴儿, 儿童, 初学者 a. 婴儿的, 幼稚的
infect	vt. 传染, 感染 [医] 传染, 感染
infection	n. 传染, 影响, 传染病 [医] 传染, 感染
infectious	a. 有传染性的, 易传染的 [医] 传染性的
inference	n. 推论 [法] 推论, 推理, 推断
inferior	a. 次等的, 较差的, 下方的, 下级的 n. 部下, 次品, 下标(符号)
infest	vt. 骚扰, 寄生于, 大批出没 [医] 传染, 感染
infinite	n. 无限, 神 a. 无穷的, 无限的, 极大的
infirmary	n. 医院, 养老院 [医] 医务所, 医务室, 小医院
inflation	n. 胀大, 夸张, 通货膨胀 [化] 充气吹胀; 膨胀
inflict	vt. 施以, 加害, 使承受 [法] 处, 加, 予以
influence	n. 影响力, 权力, 势力 vt. 影响, 改变
influx	n. 流入, 河口, 汇集 [医] 注入, 流入
information	n. 消息, 知识, 通知, 情报, 信息, 问讯处, 起诉 [计] 信息
informative	a. 提供消息的, 见闻广博的
infringe	v. 破坏, 侵犯, 违反
ingenious	a. 灵敏的, 精巧的, 聪明的
ingredient	n. 成分, 因素 [化] 配合剂; 拼料; 成分; 组分
inhabit	vt. 居住于, 占据, 栖息
inhabitant	n. 居民, 居住者 [医] 居民
inherent	a. 固有的, 与生俱来的 [医] 固有的, 生来的
inherit	vt. 继承, 遗传 vi. 接受遗产
inhibit	vt. 禁止, 抑制 vi. 起抑制作用
initial	n. 字首, 首字母 a. 开始的, 最初的, 字首的 vt. 用姓名的首字母签名
initiate	n. 入会, 开始 a. 新加入的 vt. 开始, 传授基本知识给
initiative	n. 主动行动, 首创精神, 主动权 a. 自发的, 起始的
inject	vt. 注射, 注入, 使入轨 [医] 注射
injection	n. 注射, 注射剂 [化] 注入; 注射
injury	n. 伤害, 侮辱 [医] 伤, 损伤
inland	a. 内陆的, 国内的 n. 内地
innocent	a. 无罪的, 不懂事的, 无知的 n. 天真的人, 笨蛋
innovation	n. 改革, 创新 [法] 创新, 改革, 刷新
innumerable	a. 无数的, 数不清的
inquire	v. 询问, 问明, 查究
inquiries	n. 调查( inquiry的名词复数 ); 疑问; 探究; 打听
insane	a. 患精神病的, 极愚蠢的 [医] 神经错乱的
insect	n. 昆虫, 卑鄙的人 [医] 昆虫
insects	n. 昆虫；昆虫类, 昆虫纲（insect的复数形式）
insert	n. 插入物 vt. 插入, 把(人造卫星)射入(轨道), 添写 vi. 附着 [计] 插入
insight	n. 察看, 洞察力, 见识 [医] 自知力, 洞察, 顿悟
insipid	a. 乏味的, 清淡的, 难吃的 [医] 无味的
insolent	n. 侮慢无礼的人 a. 粗野的, 无礼的, 侮慢的
insolvent	a. 无力偿还的, 破产的 n. 无力偿还者, 破产者
insomnia	n. 失眠症 [医] 失眠[症]
inspection	n. 检验, 检查, 视察 [医] 检查, 视察, 监督, 望诊
inspiration	n. 灵感, 鼓舞人心的人或物, 妙计, 吸气 [医] 吸[气]
inspire	vt. 使感动, 激发, 启示, 吸入, 鼓舞, 产生, 使生灵感 vi. 吸入, 赋予灵感
inspiring	a. 鼓舞人心的
install	vt. 安装, 安置, 使就职 [计] 安装, 安装程序; DOS内部命令:安装常驻程序
instalment	n. 就职, 装设, 分期付款
instantaneous	a. 即时的, 瞬间的, 猝发的 [机] 瞬时的
instinct	n. 本能, 直觉 a. 充满着的
institute	n. 学会, 学院, 协会 vt. 创立, 开始, 制定, 任命
institutes	n. 学院（institute的复数）
institution	n. 机构, 惯例, 制度 [医] 机关, 机构, 设施
institutions	n. 体系
instruction	n. 指令, 教导, 命令 [计] 指令
instructors	n. 指导者, 教师( instructor的名词复数 )
instrument	n. 工具, 手段, 仪器 [化] 仪器
instrumental	a. 仪器的, 器具的, 可作为手段的 [医] 器械的
instruments	n. 乐器；工具；仪器（instrument的复数）
insulate	vt. 使绝缘, 隔离 [医] 绝缘
insult	n. 侮辱, 无礼, 损害 vt. 损害, 侮辱, 攻击
insurance	n. 保险, 保险业, 保险费 [医] 保险
insure	vt. 保险, 确保 vi. 投保
intact	a. 尚未被人碰过的, 原封不动的, 完整的 [医] 完整的, 无伤的
integral	n. 整体, 积分, 整数 a. 固有的, 整体的, 整数的, 积分的 [计] 积分
integrate	vt. 综合, 使完整, 使成整体 vi. 成一体 a. 完整的, 完全的
integrity	n. 正直, 廉正, 完整 [计] 完整性
intellect	n. 智力, 出众的才华, 知识分子 [医] 智力, 才智
intellectual	n. 有知识者, 知识分子, 凭理智做事者 a. 智力的, 用脑力的, 聪明的
intelligence	n. 智力, 情报, 信息 [医] 智力
intelligent	a. 聪明的, 智能的, 了解的
intelligible	a. 可理解的, 易理解的, 纯概念性的
intense	a. 非常的, 强烈的, 紧张的, 热情的 [医] 强的
intensify	vt. 加强 vi. 强化
intensive	a. 加强的, 内涵的, 集中的 n. 加强器
intent	n. 意图, 含义, 故意 a. 专心的, 决心的, 热心的
interact	vi. 互相影响, 交互作用 n. 幕间剧, 幕间休息
interest	n. 兴趣, 嗜好, 利息, 利益, 爱好, 趣味, 势力 vt. 使感兴趣, 与...有关系
interim	a. 暂时的, 临时的, 间歇的 n. 过渡时期
interior	n. 内部, 内政 a. 内部的, 心灵的, 内地的, 内政的
intermediate	n. 中间物, 调停者, 中级 a. 中间的, 中级的 vi. 起媒介作用 [计] 中级
intermittent	a. 间歇的, 断断续续的 [化] 间歇的; 间断的
internal	a. 内在的, 国内的 [医] 内的, 内部的
international	a. 国际的 n. 国别设定 [计] 国别设定
internet	[计] 因特网, 国际互连网, 网际网络, 互连网络, 广域网
interpret	vt. 解释, 演出, 翻译, 理解 vi. 翻译, 解释
interrogate	vt. 质问, 讯问, 审问 vi. 质问, 讯问
intersection	n. 交集, 十字路口, 交叉点 [计] 逻辑乘; 与
interval	n. 间隔, 距离, 间歇, 间隙 [计] 时间间隔
intervene	vi. 插入, 调停, 干涉 [经] 进场干预
intervention	n. 插入, 介入, 调停 [经] 干预
interview	n. 面谈, 访问, 接见, 面试 vt. 接见, 对...进行面谈(试)
interviewee	n. 被接见者, 被采访者, 被面试者
interviewer	n. 会见者, 面谈者, 进行面试者
interviews	n. 接见( interview的名词复数 ); 采访; 面谈; 会谈 v. 面试( interview的第三人称单数 ); 访问; 会见; （私下）提问
intimate	a. 亲密的, 私人的, 秘密的 vt. 暗示, 通知, 告诉 n. 至交
intimidate	vt. 威胁, 恐吓 [法] 恐吓, 威胁, 使恐惧
intricate	a. 复杂的, 错综的, 缠结的, 难懂的
intrigue	n. 阴谋, 复杂的事 vi. 密谋, 私通 vt. 激起...的兴趣, 用诡计取得
intrinsic	a. 本质的, 原有的, 真正的 [医] 内部的, 内在的
introduction	n. 介绍, 传入, 采用, 初步
intuition	n. 直觉, 直觉的知识
inundate	vt. 浸水, 泛滥, 淹没, 使充满
invade	vt. 侵入, 拥入, 侵略, 侵袭 [法] 强入, 侵犯, 侵略
invalid	n. 病人, 残废者 a. 有病的, 无效的
invaluable	a. 无价的, 价值无法衡量的
invariably	adv. 不变化地, 恒定地, 始终如一地
inventory	n. 详细目录, 存货清单 vt. 列入详细目录, 清点存货 [计] 存货清单
invert	a. 转化的 vt. 使反转, 使颠倒, 使转化 n. 颠倒的事物 [计] 倒置; 反转
invest	vt. 投资, 花费, 笼罩, 授予 vi. 投资, 利用
investigate	v. 调查, 审查
investigation	n. 调查, 审查 [医] 调查, 调查研究
investigators	n. 调查者, 审查者( investigator的名词复数 )
investment	n. 投资 [医] 包埋料, 围模料, 包埋法, 围模法
invigilate	vi. 看守, 监考
invincible	a. 不能征服的, 无敌的
invisible	a. 看不见的, 无形的 [经] 无形的, 表面上看不见的, 未列在公开帐目的
invoice	n. 发票, 发货单 v. 开发票, 记清单
involve	vt. 包括, 使陷于, 潜心于, 包围 [医] 累及, 牵涉, 包含
irony	n. 反语, 讽刺, 具有讽刺意味的事
irregular	n. 不规则物, 不合规格之物 a. 不规则的, 不整齐的, 不合法的
irrespective	a. 不顾的, 无关的, 没关系的
irrigation	n. 灌溉, 冲洗 [医] 冲洗法, 灌溉
irritable	a. 易怒的, 急躁的 [医] 应激性的, 过敏的
irritate	vt. 激怒, 使发怒, 使兴奋, 使发炎 vi. 引起不快
island	n. 岛, 岛屿, 孤立地区, 安全岛 vt. 使成岛状, 孤立
isle	n. 小岛, 群岛 vt. 使成为岛状 vi. 住在岛屿上
isolate	vt. 使隔离, 使孤立, 使绝缘 n. 隔离种群
isolated	a. 孤立的, 孤零零的 [计] 隔离的, 绝缘的
isolation	n. 隔绝, 孤立, 隔离 [化] 分离; 生物分离
issue	n. 发行, 问题, 后果, 流出, 出口, 争端 vi. 发行, 流出, 造成...结果, 传下 vt. 使流出, 放出, 发行, 发布, 发给
issues	n. 议题, 问题；争点；债券（issue的复数）
Italy	n. 意大利
item	n. 项目, 条款, 一则, 项 [计] 项
items	n. 项目；名目；所有物品（item的复数形式）
itinerary	n. 旅程, 旅行指南, 游记 a. 巡回的, 旅程的
ivory	n. 象牙, 乳白色 a. 象牙制的, 乳白色的
jacket	n. 夹克, 外套, 护套 vt. 给...穿夹克, 给...装护套
jagged	a. 锯齿状的 [电] 锯齿形的
jail	n. 监牢, 监狱, 拘留所 vt. 监禁, 下狱
jam	n. 果酱, 拥塞之物, 堵塞, 困境 vt. 挤进, 使塞满, 混杂, 压碎, 使堵塞 vi. 堵塞, 轧住, 拥挤
janitor	n. 守卫, 门警, 管理人 [医] 幽门
January	n. 一月
Japanese	n. 日本人, 日语 a. 日本的, 日语的
jealous	a. 嫉妒的, 羡慕的, 留心的, 戒备的
jeans	n. 工装裤, 牛仔裤
jeer	n. 嘲笑, 讥讽, 戏弄 v. 嘲弄, 揶揄, 戏弄
jerk	n. 性情古怪的人, 急拉, 肌肉抽搐, 牛肉干 vi. 痉挛, 急拉, 急推 vt. 猛拉
jewelry	n. 珠宝, 珠宝类
job	n. 工作, 零活, 职业, 事情 vi. 做零工, 打杂, 做股票经纪, 假公济私 vt. 代客买卖, 批发, 承包, 欺骗 [计] 作业
jobs	n. 工作（job的复数形式）
jog	n. 轻推, 轻撞, 慢跑 v. 轻推, (使)蹒跚行进, (使)慢跑
jolt	n. 震摇, 摇动, 颠簸 vi. 颠簸而行, 震摇 vt. 使颠簸, 使慌张, 猛击
journal	n. 日记, 杂志, 日报 [化] 轴颈
journalist	n. 新闻记者, 从事新闻杂志业的人
judicial	a. 法庭的, 公正的, 审判上的, 司法的 [法] 司法的, 审判上的, 法官的
juice	n. 汁, 活力, 体液 vt. 挤出汁来, 加汁
July	n. 七月
jumble	vi. 搀杂, 混杂 vt. 搞乱, 使混乱 n. 混乱, 薄饼
junction	n. 连接, 会合处, 交叉点 [医] 接[合]处, 接点.[接]界
June	n. 六月
jungle	n. 丛林, 杂乱的一堆, 弱肉强食的地方
junior	n. 年少者, 地位较低者, 大学三年级学生 a. 年少的, 下级的, 后进的
junk	n. 垃圾, 乌七八糟的东西, 舢板 [计] 清除
jury	n. 陪审团, 评判委员会 a. 应急的
justification	n. 辩护, 证明正当, 释罪 [计] 调整
justify	vt. 替...辩护, 证明 vi. 证明合法 [计] 段落重排, 两端对齐
juvenile	n. 少年, 少年读物 a. 少年的, 不成熟的, 适于少年的
kangaroo	n. 袋鼠 [医] 袋鼠(澳洲产)
keen	a. 锋利的, 敏锐的, 强烈的, 敏捷的, 热心的, 渴望的 n. 挽歌, 痛哭 v. 唱挽歌, 痛哭
keep	n. 生计, 维持, 保持 vt. 保持, 保存, 遵守, 看守, 整理, 维持, 履行, 经营, 拘留, 记帐 vi. 保持, 继续不断
kelp	n. 海草, 巨藻, 海草灰 [医] 海藻
kernel	n. 核心, 中心, 精髓, 内核 [计] 内核
key	n. 钥匙, 键, 解答, 关键, 要害, 基调, 线索, 答案, 暗礁 vt. 调音, 锁上, 提供线索 vi. 使用钥匙 [计] 键, 密钥
keys	n. 关键帧；（钢琴等的）键；密钥（key的复数）
keywords	n. 关键字 [计] 关键字
kidnap	vt. 绑架, 诱拐, 拐骗 [法] 拐带, 诱拐, 绑架
kidney	n. 肾, 个性 [医] 肾
kids	n. 小山羊；儿童（kid的复数）
killer	n. (非正式)杀人者, 屠杀者, 猛兽, 致死(疾病), 杀手, 止痛药, 限制器, 瞄准器 [计] 删除程序; 断路器
kilograms	n. 千克( kilogram的名词复数 )
kin	n. 亲戚, 同族, 血缘关系, 家族 a. 有亲属关系的, 性质类似的, 同类的
kindergarten	n. 幼稚园
kindle	vt. 点燃, 使着火, 引起, 照亮 vi. 着火, 激动, 发亮
king	n. 国王, 君主 vt. 使...成为君主 vi. 君临, 统治
kit	n. 装备, 工具箱, 成套工具 [计] 成套部件; 成套零件
kitchen	n. 厨房, 全套炊具 [医] 厨房
kits	n. 装备；小桶；锦囊（kit的复数）
knife	n. 小刀, 匕首 vt. 切割, 伤害, 切, 戳 vi. 劈开, 穿过
knit	v. 编织, 结合
knob	n. 把手, 瘤, 旋钮, 球形突出物 vt. 使有球形突出物 vi. 鼓起
knot	n. 结, 群, 难题 v. 打结, (使)纠缠
knowledge	n. 知识, 学问, 认识, 知道
lab	n. 实验室, 研究室 [医] 凝乳酶
laboratory	n. 实验室, 研究室, 化工厂 [医] 实验室, 检验室, 化验室
laborious	a. 艰苦的, 费劲的, 勤劳的
lace	n. 饰带, 花边, 缎带, 鞋带 vt. 结带子, 饰以花边 vi. 系带子 [计] 全穿孔
lack	n. 缺乏, 无, 不足 vt. 缺乏, 短少, 不足, 需要 vi. 缺乏
laden	a. 装满的, 负载的, 苦恼的 lade的过去分词
lag	n. 落后, 囚犯, 迟延, 桶板, 防护套 a. 最后的 vi. 落后, 蹒跚, 缓缓而行, 滞后 vt. 落后于, 押往监狱, 加上外套 [计] 延迟; 落后
lake	n. 湖, 池, 色淀 v. (使)血球溶解
lakes	n. 色淀；湖泊, 湖畔
lamb	n. 小羊, 羔羊 v. 产羊羔
lame	a. 跛足的, 僵痛的, 不完全的, 金属薄板, 不知内情的人 vi. 变跛 vt. 使成残废, 使无用
lament	n. 悲叹, 悔恨, 恸哭, 挽歌, 悼词 vt. 哀悼 vi. 悔恨, 悲叹
lamp	n. 灯 vt. 照亮 [计] 逻辑模拟分析系统
land	n. 陆地, 地面, 地界, 地产, 国土, 土地 vi. 登陆, 登岸, 到达 vt. 使上岸, 使登陆, 使到达 [计] 连接盘; 焊盘
landlady	n. 女房东, 女地主
landscape	n. 风景, 山水, 风景画 vi. 从事景观美化 vt. 美化...景观 [计] 横向
lane	n. 小路, 巷, 弄, 单行道
language	n. 语言, 文字, 措辞 [计] 语言
languid	a. 疲倦的, 无力的, 阴沉的
lap	n. 膝盖, 舔, 一圈, 下摆, 衣兜, 山坳 vi. 重叠, 围住, 轻拍, 舔 vt. 包围, 抱...在膝上, 使重叠, 舔, 拍打, 泼溅 [计] 链接访问程序
lapse	n. 过失, 流逝, 失效 vi. 犯错, 堕落, 减退, 消失, 流逝 vt. 使失效
laser	n. 激光 [计] 激光器
lash	n. 鞭子, 鞭打, 睫毛, 责骂, 讽刺 vt. 鞭打, 摆动, 扎捆, 冲击, 讽刺, 煽动 vi. 冲洗, 鞭打, 责骂
latent	a. 潜伏性的, 隐藏的 n. 隐约指纹
lateral	n. 侧部, 支线, 边音 a. 侧面的, 旁边的
latest	a. 最近的
latitude	n. 纬度, 范围 [化] 宽容度; 伟度
laudable	a. 值得赞赏的, 值得佩服的 [医] 健康的
launch	n. 下水, 汽艇, 发射 vt. 使下水, 发射, 发动 vi. 起飞, 下水, 投入, 开始
laundry	n. 洗衣店, 洗好的衣服, 洗涤 [机] 洗衣作, 洗衣店, 洗衣房
lava	n. 熔岩, 火山岩 [医] 火山石(一种顺势疗法药)
lavish	a. 大方的, 丰富的, 浪费的 vt. 浪费, 滥用, 慷慨给予
law	n. 法律, 法则, 定律, 法律的制约, 法学, 司法界, 诉讼 v. 起诉
lawn	n. 草地, 草坪, 上等细麻布 [机] 细筛
lawyer	n. 律师 [经] 律师
lax	a. 松的, 不严格的, 腹泻的, 松弛的 n. 腹泻, 松元音
lay	vt. 放置, 产, 铺设, 布置, 提出, 平息 vi. 下蛋, 打赌 n. 位置, 层, 隐藏处 a. 世俗的, 外行的 lie的过去式
layer	n. 层, 产卵鸡, 放置者 vt. 分层堆积, 压植 [计] 层
layman	n. 俗人, 门外汉, 凡人 [医] 外行, 业外人
layoff	n. 临时解雇, 操作停止, 活动停止期间
layout	n. 布局, 陈列, 规划图, 页面布局, 版面编排 [计] 页面布局, 版面
leaflet	n. 小叶, 传单 [医] 小叶
leak	n. 漏洞, 漏处, 漏出, 泄漏 vi. 漏, 泄漏 vt. 使渗漏
leap	n. 跳跃, 剧增, 急变, 被越过之物 vi. 跳跃, 突然经过 vt. 跃过, 使跃过
learn	vt. 学习；认识到；得知
lease	n. 租约, 租期, 租 vt. 出租, 租出, 租得
least	n. 最少, 最小, 最小限度 a. 最少的, 最小的 adv. 最小, 最少
leave	n. 许可, 告别, 请假, 休假 vt. 离开, 剩下, 遗忘, 委托, 丢弃 vi. 出发, 离开, 生叶
lecture	n. 演讲, 谴责, 讲稿 vt. 演讲, 训诫, 说教 vi. 讲演
legal	a. 法律的, 法定的, 合法的 [经] 法定权利; 法律(上)的, 合法的
legend	n. 传说, 传奇文学, 图例 [计] 图例
legislate	vi. 制定法律 vt. 用立法规定
legislation	n. 立法, 法律 [医] 立法, 法规
legitimate	a. 合法的, 正当的, 婚生的 vt. 认为正当, 立为嫡嗣, 使合法
leisure	n. 空闲, 闲暇, 悠闲 a. 空闲的, 有闲的
lemon	n. 柠檬, 柠檬树, 柠檬色 [医] 柠檬
lender	n. 出借人, 贷方 [经] 出借者, 贷方, 贷款人
length	n. 长度, 长, 期间, 一段 [计] 记录长度; 块长; 字长
lenient	a. 宽大的, 温和的, 慈悲为怀的 [法] 宽大的, 仁慈的
lens	n. 透镜, 镜头, 镜片, 晶状体 vt. 给...摄影
leprosy	n. 麻疯病, 腐败 [医] 麻风
lessons	n. 功课( lesson的名词复数 ); 课程; 教训; 一堂课
let	vt. 让, 假设, 出租, 排放, 妨碍 vi. 出租, 被承包 n. 出租屋, 障碍
lethal	a. 致命的 n. 致死因子
letter	n. 信, 字母, 证书, 字面意义, 铅字, 学问, 出租人 vt. 写字母于, 在...上刻字母, 用字母标明 vi. 写印刷体字 [计] 字母
level	n. 水平, 水准, 平地 a. 同高的, 平坦的, 齐平的, 水平的 vt. 弄平, 夷平, 使同等, 瞄准, 对准 vi. 变平, 拉平 [计] 级别
levels	n. 色阶调整；控制色阶；水平, 标准（level复数形式）
lever	n. 杠杆, 似杠杆之工具 vt. 撬开 vi. 使用杠杆
levy	n. 税款, 所征的人数, 征收 vi. 征税, 课税 vt. 征收, 强求, 召集
liability	n. 责任, 债务, 倾向 [经] 责任, 义务, 负债
liable	a. 有义务的, 应负责的, 有...倾向的 [法] 有责任的, 可受处理的, 应受罚的
liaison	n. 联络
liberal	n. 自由主义者 a. 慷慨的, 不拘泥的, 宽大的, 自由主义的
libraries	n. 图书馆查询系统；函数库；图书馆（library的复数）
library	n. 图书馆, 藏书, 库 [计] 库
licence	n. 执照, 许可证, 特许 vt. 许可, 特许, 认可
lick	n. 舔, 少许, 打 vt. 舔, 卷过, 鞭打 vi. 轻轻拍打
lifestyle	n. 生活方式
lift	n. 举起, 帮助, 昂扬, 电梯 vt. 升高, 提高, 鼓舞, 清偿, 空运, 举起, 剽窃 vi. 升起, 消散, 耸立
light	n. 光, 光亮, 灯, 日光, 发光体, 光源, 杰出人物, 火花, 眼光 a. 轻的, 少量的, 轻微的, 轻快的, 轻浮的, 明亮的, 淡色的, 容易的 vt. 点燃, 照亮 vi. 点着, 变亮, 突降, 偶然碰到 adv. 轻地
lights	n. （供食用的）家畜的肺脏；灯光（light的复数）
likelihood	n. 可能, 可能性
likewise	adv. 同样地, 也
limb	n. 四肢, 枝干, 翼, 边缘 vt. 切断...之手足
limp	n. 跛行 a. 柔软的, 无力的, 软弱的 vi. 跛行
line	n. 列, 线, 绳, 电线, 线路, 路线, 航线, 作业线, 界线, 战线, 外形, 排, 家系 vt. 排成一行, 顺...排列, 划线于, 加衬里, 使有线条, 使起皱纹 vi. 排队 [计] 线路
linear	a. 线的, 直线的, 线状的 [计] 线性
linen	n. 亚麻布, 亚麻线, 亚麻制品 a. 亚麻布制的, 亚麻的
liner	n. 班机, 划线者, 定期船, 衬里 [化] 衬垫; 垫带; 套管
linger	vi. 逗留, 消磨, 徘徊 vt. 消磨
linguistics	n. 语言学
link	n. 环, 连结物, 链接, 火把 vt. 连结, 联合, 挽住 vi. 连接起来 [计] 连接, 链路
lions	n. 腰角；雄狮；狮子（lion的复数）
liquor	n. 酒, 液体, 汁, 溶液 vt. 浸水 vi. 喝酒
list	n. 目录, 名单, 明细表, 布条, 条纹, 列表, 序列, 数据清单 vt. 列出, 列于表上, 记入名单内, 装布条 vi. 列于表上 [计] 列表, 序列, 数据清单
literacy	n. 读写能力, 识字, 精通文学
literally	adv. 逐字地, 按照字面上地, 不夸张地
literature	n. 文学, 文艺, 著作 [经] 广告, 商品介绍等文学
litter	n. 垃圾, 杂乱, 轿, 担架 vt. 乱丢, 铺草, 弄乱 vi. 产仔, 乱丢垃圾
live	a. 活的, 生动的, 精力充沛的, 实况转播的 vi. 活, 生存, 居住 vt. 过着, 度过, 经历 adv. 实况地
livestock	n. 家畜 [经] 牲畜, 家畜
loaf	n. 一条面包, 块, 游荡 v. 游手好闲, 虚度光阴
loan	n. 贷款, 借出 v. 借, 供应货款, 借给
loans	n. 借贷；贷款（loan的复数形式）
loath	a. 不情愿的, 厌恶的
lobby	n. 大厅, 休息室, 游说议员者 vi. 游说议员, 游说 vt. 游说
local	a. 地方性的, 当地的, 局部的, 乡土的, 本地的 n. 当地居民, 本地新闻, 局部 [计] 本地的; 局部
locality	n. 地方, 所在, 位置 [法] 位置, 场所, 地区
location	n. 位置, 场所, 特定区域 [计] 位置
locations	n. 位置；定位件；地点（location的复数）
lock	n. 锁, 刹车, 水闸, 一缕头发 vt. 锁, 锁上, 拘禁, 隐藏, (用锁等)拴住, 刹住 vi. 锁住, (齿轮等)啮合, (船)过闸
locker	n. 抽屉, 小柜, 上锁人 [机] 锁柜
locomotive	n. 火车头, 机车 a. 运转的, 火车头的, 移动的
lodge	n. 小屋, 门房, 支部, 旅舍, 分会 vi. 临时住宿, 倒伏, 寄宿, 投宿 vt. 安顿, 容纳, 提出, 把...射入, 存放
lodging	n. 寄宿处, 寄宿 [法] 提起, 住所
lofty	a. 高的, 傲慢的, 崇高的, 高级的, 玄虚的
log	n. 记录, 圆木, 日志, 计程仪 vt. 伐木, 切, 航行 vi. 伐木 [计] 日志
logic	n. 逻辑, 逻辑学, 推理的方法, 推理, 逻辑性 [计] 逻辑
loll	vi. 懒散地闲荡, 垂下头, 伸舌 vt. 垂, 伸, 靠着
London	n. 伦敦
longitude	n. 经度, 经线 [电] 经度
loom	n. 织布机, 若隐若现的景象 vi. 朦胧地出现, 隐约可见, 可怕地出现
loop	n. 环, 圈, 弯曲部分, 循环 vt. 使成环, 以圈结, 以环连结 vi. 打环, 翻筋斗 [计] 循环
loss	n. 损失, 遗失, 失败, 输, 错过, 伤亡 [化] 损失; 损耗
loth	a. 不愿意的, 厌恶的
lottery	n. 奖券, 彩票, 运气 [经] 抽彩给奖法
lounge	n. 闲逛, 休闲室, 长沙发 vi. 闲混, (懒洋洋地)躺 vt. 闲混
low-risk	 [医]低危的, 低风险的
loyal	a. 忠诚的, 忠实的, 忠贞的
lubricate	vt. 使润滑, 涂油 vi. 润滑
lucid	a. 明晰的, 清澈的, 透明的, 透彻的 [医] 清明的, 透明的, 清醒的
luck	n. 运气, 幸运, 好运, 侥幸 vi. 靠好运成功
lucrative	a. 有利益的, 获利的, 合算的
ludicrous	a. 可笑的, 滑稽的, 荒唐的
lull	n. 暂停, 间歇, 稍息, 使人安静的东西 vt. 使平静, 哄骗, 使安静 vi. 变平静
luminous	a. 发光的, 明亮的 [医] 发光的
lump	n. 块, 瘤, 很多, 肿块, 笨人 vt. 使成块状, 混在一起 vi. 结块
lunar	a. 阴历的, 月的, 微亮的(指光) [医] 月的, 银的
lunch	n. 午餐
lure	n. 饵, 诱惑 vt. 引诱, 诱惑
lurk	n. 潜伏, 潜行 vi. 暗藏, 潜伏, 埋伏 [计] 隐匿阅读
luxury	n. 奢侈, 豪华 a. 奢侈的, 豪华的
machine	n. 机器, 机械装置, 机构, 自动售货机, 机械般工作的人 vt. 以机器制造
machines	n. 机器；机械（machine的复数）
mackintosh	n. 马金托什防水布, 马金托什雨衣 [化] 防水胶布; 胶布雨衣
madden	vt. 使发狂, 激怒 vi. 发狂, 发怒
magazine	n. 杂志, 仓库, 弹盒, 胶卷盒 [计] 卡片箱, 介质装卸程序
magic	n. 魔术, 魔法 a. 魔术的, 有魔力的, 不可思议的
magistrate	n. 长官, 法官, 推事 [法] 司法行政官, 治安法官, 地方法官
magnanimous	a. 宽宏大量的, 有雅量的 [法] 气量大的, 宽大的, 高尚的
magnate	n. 大官, 巨头 [法] 大官, 权贵, 大资本家
magnetic	a. 有磁性的, 有吸引力的, 催眠术的 [医] 磁[性]的
magnificent	a. 华丽的, 高尚的, 宏伟的
magnify	vt. 放大, 扩大, 赞美, 夸大 vi. 有放大能力
magnitude	n. 巨大, 重大, 重要, 大小, 数量, 星等(指星的亮度) [计] 大小; 值
maid	n. 少女, 未婚女子, 女仆
maiden	n. 年轻未婚女子, 少女, 处女 a. 未婚的, 处女的, 初次的, 无经验的
mail	n. 邮件, 邮政, 邮递, 盔甲 vt. 邮寄, 给...穿盔甲 [计] 邮件
mails	n. 邮件（mail的复数形式）
maim	vt. 使残废, 使不能工作, 使伤残 [医] 伤残, 残废
main	n. 主要部分, 干线, 体力, 力量, 主群组 a. 主要的, 重要的, 全力的 [计] 主群组
maintain	vt. 维持, 维修, 保持, 坚持, 供养, 主张 [化] 维修
maintenance	n. 维护, 保持, 维修, 生活费用, 坚持, 扶养 [计] 维护; 维修
maize	n. 玉蜀黍, 黄色 a. 玉蜀黍色的, 黄色的
majestic	a. 宏伟的, 庄严的
major	n. 主修课, 成年人, 陆军少校 a. 主要的, 较多的, 大部分的, 成年的, 严重的 vi. 主修 [计] 主要, 主要刻度
majority	n. 多数, 大半 [计] 多数逻辑
majors	n. 专业；主修（major的复数）
make	vt. 制造, 安排, 创造, 构成, 使得, 产生, 造成, 整理, 布置, 引起, 到达, 进行 vi. 开始, 前进, 增大, 被制造, 被处理 n. 制造, 构造, 性情
making	n. 制造, (手工)制造业, 制作, 形成, 发展, 要素, 内在因素, 赚头, 制造物
malaria	n. 疟疾, 瘴气 [医] 疟[疾]
Malaysia	n. 马来西亚 [经] 马来西亚
male	n. 男人, 雄性动物 a. 男性的, 雄性的, 有力的
malice	n. 恶意, 蓄意害人, 怨恨 [法] 预谋, 蓄意, 恶意
malignant	a. 有恶意的, 恶性的, 有害的 [化] 恶性的
mall	n. 林荫路
malleable	a. 有延展性的, 可锻的 [医] 可展的, 易适应的
malnutrition	n. 营养失调, 营养不良 [医] 营养不良
maltreat	vt. 虐待, 滥用 [法] 粗暴对待, 虐待, 乱用
mammal	n. 哺乳动物 [化] 哺乳动物
manacle	n. 手铐, 束缚 vt. 给...上手铐, 束缚
management	n. 经营, 支配, 管理 [化] 管理处
manager	n. 经理, 管理员, 管理器 [计] 管理器
mandate	n. 命令, 指令, 要求 vt. 委任统治
mandatory	a. 命令的, 托管的 [经] 受托者, 命令者
maneuver	n. 演习, 调遣, 策略 v. 调遣, 演习, 用计
mania	n. 狂躁, 热衷, 狂热 [医] 躁狂, 狂
maniac	a. 发狂的, 癫狂的, 疯狂的 n. 狂人, 疯子
manifest	n. 载货单, 运货单, 旅客名单 a. 显然的, 明白的 vi. 显示, 出现 vt. 表明, 表现, 证明
manifold	n. 复印本, 多种 a. 多种的, 有许多部分的, 多方面的 vt. 复写, 使多样化, 增多
manipulate	vt. 操纵, 利用, 操作, 巧妙地处理, 假造
mannerism	n. 矫揉造作, 习性 [医] 装相, 作态
mansion	n. 大厦, 宅邸
mantle	n. 斗篷, 罩子, 披风 vt. 罩住, 覆盖 vi. 覆盖, 脸红
manual	n. 手册, 指南 a. 手的, 手动的, 手工的, 体力的 [计] 人工的, 手动的
manufacture	n. 产品, 制造 vt. 制造, 假造 vi. 制造
manure	n. 肥料, 粪肥 vt. 施肥于
manuscript	n. 手稿, 原稿, 底稿 a. 手写的
map	n. 地图, 天体图, 映像 vt. 映射, 绘制...地图, 计划 [计] 实用程序, 映射, 制造自动化协议
mar	vt. 损毁, 损伤, 糟蹋 n. 三月
marble	n. 大理石, 石弹, 雕刻品 a. 大理石的, 冷酷无情的, 有大理石花纹的
march	n. 三月, 进行, 行军, 步伐, 长途跋涉, 进行曲, 边界 vi. 进军, 前进, 交界 vt. 使行军, 使行进
margin	n. 页边的空白, 边缘, 界限, 余裕, 差数, 差额, 保证金 vt. 加边于, 加旁注于 [计] 页边距
marginal	a. 边缘的, 最低限度的, 有旁注的 [医] 缘的
marine	n. 舰队, 水兵, 海景画 a. 海的, 海产的, 海底的, 船舶的, 海运的
marital	a. 丈夫的, 婚姻的, 夫妇间的 [医] 婚姻的
maritime	a. 海的, 海上的, 海事的, 沿海的, 海员的 [经] 海事的, 海上的, 海员的
market	n. 市场, 交易, 集市, 推销地区, 行情, 市面, 销路 vt. 在市场上交易, 使上市, 销售 vi. 在市场上买卖
marketing	n. 行销, 买卖 [经] 推销, 在市场买卖, 销售
marks	n. 标记, 记号；唛头, 分数；台面标志
marrow	n. 髓, 骨髓, 精华, 活力, 配偶 [医] 髓(尤指骨髓)
marsh	n. 沼泽, 湿地 a. 沼泽的
martial	a. 战争的, 军事的, 尚武的, 威武的 [医] 含铁的
martyr	n. 烈士, 受苦者, 受难者 vt. 使成为烈士, 使受苦
marvel	n. 奇异事物, 罕见例子 vt. 惊异于 vi. 惊异
marvelous	a. 令人惊异的, 了不起的, 不平常的
masculine	n. 阳性, 男性 a. 男性的, 阳性的, 有丈夫气的
mask	n. 面具, 假面具, 掩饰, 石膏面模 vt. 戴面具, 掩饰, 使模糊 vi. 化装, 戴面具, 掩饰, 参加化装舞会 [计] 屏蔽; 掩码
mass	n. 块, 大多数, 质量, 大量, 群众, 弥撒 a. 群众的, 大规模的, 整个的 vt. 使集合, 集中 vi. 聚集
massacre	n. 大屠杀 vt. 大屠杀, 残杀
massive	a. 大而重的, 宽大的, 宏伟的 [医] 大块的, 整块的, 大量的
master	n. 主人, 硕士, 大师, 母机 a. 主人的, 主要的 vt. 征服, 控制, 精通
masterpiece	n. 杰作, 名著
match	n. 比赛, 火柴, 对手 vt. 使相配, 使比赛, 与...竞争 vi. 结婚, 相配 [计] 比较
matching	a. 相同的, 协调的 [计] 匹配, 对比
material	n. 材料, 物资, 素材, 布料, 资料 a. 物质的, 肉体的, 重要的
materials	n. 材料；材料费；材料科学；材质（material的复数）
maternal	a. 母亲的, 母系的, 母方的 [医] 属母的, 母的, 母性的
mathematic	[计] 数学的
mathematics	n. 数学 [机] 数学
matrimony	n. 结婚, 婚姻生活, 婚礼 [法] 婚姻, 结婚, 婚礼
mature	a. 成熟的, 到期的, 充分考虑的 vt. 使成熟 vi. 成熟, 到期
maximum	n. 极点, 最大量, 极大 a. 最高的, 最大的, 最大极限的 [计] 最大值
may	n. 五月 aux. 愿能, 可以, 愿意
meadow	n. 草地, 牧场
meagre	a. 瘦的, 不毛的, 贫乏的, 贫弱的, 少量的, 力量不够的, 质不高的, 量不足的
meal	n. 一餐, 膳食, 粗粉 vi. 进餐
meals	n. 膳食；谷类（meal的复数）
mean	a. 低劣的, 卑贱的, 简陋的, 吝啬的, 惭愧的, 平均的, 中间的, 普通的 vt. 意谓, 想要, 意欲, 预定 vi. 用意, 有意义 n. 平均数, 中间, 中庸
means	n. 方法, 手段, 工具, 财产, 收入 [经] 方法, 手段, 工具; 意谓
measure	n. 尺寸, 量度器, 量度标准, 测量, 量具, 程度, 范围, 限度, 分寸, 措施, 方法 vt. 测量, 测度, 估量, 权衡, 调节, 拿(自己或自己的力量等)作较量 vi. 度量
measurement	n. 尺寸, 度量, 度量单位 [计] 度量, 度量单位
measurements	n. 测量值, 尺寸（measurement的复数）
meat	n. 肉, 餐, 食物 [经] 肉类
mechanism	n. 机械, 机构, 结构, 机理, 技巧 [化] 机理; 历程; 机构
medal	n. 奖牌, 勋章 vt. 授勋予
meddle	vi. 干涉, 干预, 擅自摸弄 [法] 干预, 插手, 弄乱
media	n. 媒体 [计] 媒质
mediate	a. 居间的, 间接的 vt. 斡旋, 调停 vi. 处于中间, 调解
medical	n. 医生, 体格检查 a. 医学的, 内科的, 药的
medicine	n. 药, 医学, 内科 vt. 给...用药
medieval	a. 中古的, 中世纪的
mediocre	a. 不好不坏的, 通常, 平凡的
meditate	vt. 想, 考虑, 计划 vi. 沉思, 反省
medium	n. 媒体, 方法, 媒介 a. 半生熟的, 中间的 [计] 媒体, 中
meek	a. 温顺的, 逆来顺受的
meeting	n. 会议, 会面 [法] 会议, 会谈, 集会
melancholy	n. 忧郁, 悲哀, 愁思 a. 忧郁的, 使人悲伤的, 愁思的
Melbourne	n. 墨尔本
melodious	a. 旋律美妙的, 旋律优美的, 有乐曲的
melody	n. 曲子, 美妙音乐, 曲调
membership	n. 会员的资格, 全体会员, 会员数目 [法] 会员资格, 成员资格, 会籍
memento	n. 纪念物, 令人回忆的东西
memorise	vt. 记住, 熟记, 记录, 存储
menace	n. 威胁, 胁迫 v. 威吓, 胁迫
mental	a. 心智的, 精神病的, 心理的, 颏的 n. 精神病患者
mentality	n. 精神力, 智力, 头脑作用, 心态 [医] 智力
mercantile	a. 商业的, 商人的 [经] 商业的
mercenary	n. 唯利是图者, 雇佣兵 a. 为钱而工作的, 被雇的, 图利的
mercy	n. 仁慈, 宽恕, 慈悲, 怜悯, 幸运 [法] 权宜处置权, 决定权, 宽恕
merge	vt. 使合并, 使消失, 吞没 vi. 合并, 渐渐消失 [计] 合并
merit	n. 优点, 功绩, 价值, 功过, 真相 vt. 值得 vi. 应受
mesh	n. 网孔, 网丝, 网眼, 网状物, 圈套, 陷阱, 啮合 vt. 以网捕捉, 啮合, 使缠住 vi. 落网, 相啮合
mess	n. 食堂, 伙食, 用膳, 一份食品, 混乱, 乱七八糟, 困境 vt. 将...弄糟, 妨碍, 使紊乱, 使就餐 vi. 陷入困境, 搞乱, 用膳
metabolism	n. 新陈代谢, 变态 [化] 新陈代谢; 代谢
metal	n. 金属, 金属制品, 合金, 本质, 质料 a. 金属制的 vt. 以金属覆盖
metallic	a. 金属的, 含金属的, 产生金属的 [经] 金属的
metaphor	n. 隐喻
meteoric	a. 流星的, 疾速的, 大气的
meteorology	n. 气象学, 气象状态 [医] 气象学
method	n. 方法, 办法, 条理, 秩序 [医] [方]法
methods	n. 方法, 方式；研究方法（method的复数）
meticulous	a. 一丝不苟的, 精确的, 过细的
metric	a. 公尺的, 公制的, 计量的 [医] 测量的, 米制的, 公制的
metropolitan	n. 大都市居民, 都主教, 宗主国的公民 a. 大都市的, 都主教区的, 宗主国的
microbe	n. 微生物, 细菌 [医] 微生物
microbiology	n. 微生物学 [化] 微生物学
microcosm	n. 小宇宙, 小世界, 人类
microfilm	n. 缩影胶卷 v. 缩微拍摄 [计] 缩微胶片; 缩微胶卷
microphone	n. 扩音器, 麦克风 [医] 扩音器, 传声器
mid	a. 中间的, 中央的, 中部的 prep. 在...之中
midmorning	n. 上午十时左右
midnight	n. 午夜, 子夜, 半夜 a. 午夜的, 半夜的
might	n. 力量, 权力 aux. 可能, 也许
mighty	n. 有势力的人 a. 有势力的, 强大的, 有力的 adv. 很, 极
migrate	vi. 移动, 移往, 随季节而移居 [计] 迁移程序
migration	n. 移民, 移往, 移动 [计] 迁移
migratory	a. 迁移的, 流浪的
mildew	n. 霉 vi. 发霉, 生霉 vt. 使发霉
mileage	n. 英里数 [经] 运费(按英里计算的)
miles	n. 英里（1英里约合1609米, mile的复数形式）
militant	a. 好战的
milk	n. 奶, 乳状物 vt. 挤乳, 榨取 vi. 产乳
millennium	n. 千禧年, 一千年
million	n. 百万, 无数 num. 百万
mills	n. 米尔斯（人名）
mimic	a. 模仿的, 摹拟的 n. 效颦者, 模仿者, 小丑, 仿制品 vt. 模仿, 摹拟
mind	n. 思想, 愿望, 智力, 记忆, 心理, 情绪, 理智, 主意, 心意 vi. 介意, 注意, 留心 vt. 注意, 留意, 专心于, 照看, 介意
mine	n. 矿, 矿藏, 地雷 vt. 挖掘, 开采, 在...布雷, 破坏 vi. 开矿, 埋设地雷 pron. 我的
mingle	v. (使)混合
minimal	a. 最小的, 极微的, 最小限度的 [医] 最小的, 最低的
minimum	a. 最小的, 最低的 n. 最小值 [计] 最小值
mining	n. 采矿 [经] 采矿, 采矿业
minister	n. 部长, 牧师, 公使 vi. 服侍, 救助, 主持宗教仪式
minority	n. 少数, 未成年, 少数民族 a. 少数的, 属于少数派的
mint	n. 薄荷, 造币厂, 巨额 vt. 铸造, 铸币, 制造
minus	n. 负号, 不足 a. 减的, 负的, 阴性的 prep. 减, 缺 [计] 负差
minute	n. 分, 分钟, 片刻, 备忘录, 笔记 vt. 记录, 摘录, 测定时间 a. 微小的, 详细的
minutes	n. 会议记录 [法] 备忘录, 会议记录, 审判记录
miracle	n. 奇迹, 奇事
mirage	n. 海市蜃楼, 幻景, 妄想
mire	n. 泥沼, 泥泞 vt. 使陷于泥泞, 使陷入困境 vi. 掉进泥坑
miscarriage	n. 失败, 误送, 流产 [医] 流产
mischance	n. 不幸, 灾难
mischief	n. 损害, 伤害, 灾祸, 恶作剧, 淘气 [法] 损害, 伤害, 危害
misconceive	v. 误解
misdeed	n. 罪行, 犯罪 [法] 不端行为, 犯罪, 恶性
miserable	a. 悲惨的；痛苦的；卑鄙的
misery	n. 痛苦, 悲惨, 不幸, 穷困
misfortune	n. 不幸, 灾祸, 坏运气 [法] 不幸事故, 不幸, 灾祸
misgiving	n. 疑虑, 不安, 害怕, 担扰, 疑惧
mishap	n. 不幸之事, 灾祸, 恶运
misrepresent	vt. 不如实地叙述(或说明), 不称职地代表
missile	n. 发射物, 导弹, 飞弹, 火箭 a. 可发射的
mission	n. 任务, 代表团, 使命, 传教团 vt. 派遣, 向...传教
mist	n. 雾, 迷蒙, 朦胧不清 vt. 使模糊, 使蒙上雾 vi. 变模糊, 下雾
misuse	n. 误用, 滥用 vt. 误用, 滥用, 虐待
mitigate	vt. 温和, 缓和, 减轻 [医] 缓和, 减轻
mixture	n. 混合, 混淆, 混合物 [化] 混合物
mobile	a. 移动的, 易变的, 机动的 n. 活动物体
mobilize	vt. 动员, 调动, 使流通 vi. 动员
mock	n. 嘲笑, 戏弄, 模仿 a. 假的, 伪造的, 模拟的 adv. 虚伪地 vt. 嘲弄, 模仿, 使失望, 欺骗, 挫败 vi. 嘲弄
mode	n. 模态, 调式, 样式, 文体, 状态, 方式, 风尚 [计] 方式; DOS外部命令:设定各种设备命令
model	n. 模型, 模范, 模特儿 a. 模范的, 作模型用的 vi. 做模型, 做模特儿 vt. 使模仿, 塑造 [计] 模型
moderate	a. 适度的, 稳健的, 中等的, 节制的 vt. 节制, 减轻, 使缓和 vi. 变缓和, 主持会议
modern	n. 现代人, 有思想的人 a. 现代的, 时髦的
modest	a. 谦逊的, 羞怯的, 端庄的, 适度的 [经] 适当的
modify	vt. 修正, 变更, 修饰, 缓和, 减轻 vi. 被修改 [计] 修改
module	n. 组件, 模数 [计] 模块
moist	a. 潮湿的, 多雨的, 感伤的, 含泪的 [医] 湿的
molecule	n. 分子, 些微 [化] 分子
molest	vt. 妨碍, 干扰, 调戏 [法] 调戏, 作弄, 恶意干涉
momentous	a. 重大的, 重要的
momentum	n. 动力, 动量 [化] 动量
monarchy	n. 君主政体, 君主国, 君主政治 [法] 君主政体, 君主制度, 君主国
Monday	n. 星期一
monetary	a. 货币的, 金钱的 [经] 货币的, 金融的
money	n. 金钱, 一笔款, 财富, 货币, 金额 [经] 货币, 金钱, 财产
monitor	n. 监督器, 级长, 监听员, 班长, 监视器, 告诫物 v. 监视, 监听, 监督 [计] 监视器, 监视程序; 监视
monologue	n. 独白, 独脚戏, 独白场面, (非正式)(贬)滔滔不绝的话
monopoly	n. 垄断, 专卖权, 独占事业 [经] 垄断, 专利品, 垄断(权)独占
monotonous	a. 单调的, 无变化的
monsoon	n. 季风, 吹季风的季节, 雨季
monster	n. 怪物, 恶人, 巨物 [医] 畸胎
monstrous	a. 巨大的, 畸形的, 怪异的 [法] 巨大的, 异形的, 畸形的:荒诞的
month	n. 月 [经] 月
mood	n. 心情, 气氛, 生气, 基调 [医] 心境
morality	n. 道德, 教训, 品行 [法] 道德, 道义
morbid	a. 致病的, 病态的, 疾病的, 可怕的 [医] 病的
moreover	adv. 而且, 此外
mortal	n. 生物, 人类 a. 不免一死的, 人类的, 临终的
mortgage	n. 抵押, 约束性义务, 抵押借款 vt. 抵押, 以...作担保, 把...许给
mosaic	n. 马赛克, 镶嵌细工, 镶嵌工艺 a. 马赛克的, 镶嵌细工的, 拼花的 vt. 用镶嵌细工装饰 [计] Mosaic浏览程序
mosquito	n. 蚊子 [医] 蚊
most	n. 最多, 最大 a. 大多数的, 几乎全部的, 最多的 adv. 最, 最多, 极其
motel	n. 汽车旅馆
mother	n. 母亲, 修女院长 vt. 产生, 照看, 收养
motif	n. 主题, 基调, 动机, 基本图案 [法] 主旨, 主题, 动机
motion	n. 移动, 手势, 动作, 意向, 请求, 提议 v. 打手势
motivate	vt. 给与动机, 刺激, 提高...的学习欲望, 促动 [经] 促动, 激发, 激励
motivation	n. 动机, 刺激, 推动 [医] 促动, 推动, 诱导
motorcycle	n. 摩托车 [机] 机动车, 机踏车, 摩托车
motto	n. 箴言, 座右铭, 警句
mould	n. 模子, 模制品, 松软沃土, 霉 vt. 形成, 浇铸, 用泥土覆盖 vi. 发霉
mount	n. 乘骑用马, 框, 衬纸, 山 vi. 乘马, 爬上, 增长 vt. 爬上, 使上马, 装上, 装裱, 安放, 制作...的标本, 设置, 上演 [计] 安装
mountain	n. 山, 山脉, 大堆
mourn	v. 哀悼, 忧伤, 服丧
moustache	n. 髭, 小胡子, 触须
movie	n. 电影
movies	n. 电影
mucous	a. 粘液的, 粘的, 粘液性的 [医] 粘液的
muddle	vt. 混合, 使微醉, 使咬字不清晰 vi. 胡乱对付 n. 困惑, 混浊状态
multilateral	a. 多边的, 多国的 [经] 多边的, 涉及多方的
multiply	v. 繁殖, 乘, 增加 [计] 乘
multitude	n. 多数, 群众
mundane	a. 现世的, 世俗的, 宇宙的
municipal	a. 市政的, 自治区的, 内政的 [经] 市政的, 市的
murmur	n. 低语, 低声的怨言 vi. 低语, 低声而言 vt. 低声说
muscles	n. 肌肉（muscle的复数）
muscular	a. 强壮的, 肌肉发达的, 有力的 [医] 肌的; 肌肉发达的
museum	n. 博物馆
mushroom	n. 蘑菇形物, 蘑菇, 暴发户 vi. 迅速生长, 迅速增加, 采蘑菇 a. 蘑菇形的, 迅速生长的
music	n. 音乐, 乐曲
musical	n. 音乐片, 音乐舞台剧 a. 音乐的, 声音美妙的, 喜爱音乐的
muster	n. 召集, 集合, 检阅, 清单, 花名册, 样品 vt. 召集, 集合, 应召 vi. 集合, 集中
mutation	n. 变化, 突变, 元音变化 [化] 突变
mutter	n. 喃喃低语 vi. 喃喃自语, 作低沉声 vt. 出怨言, 抱怨地说
mutual	a. 相互的, 共有的 [经] 相互的
myriad	n. 无数, 无数的人(或物) a. 无数的, 种种的
myth	n. 神话, 虚构的事, 虚构的人
mythology	n. 神话
naked	a. 裸体的, 无装饰的, 无保护的, 赤贫的 [医] 裸露的
namely	adv. 即, 就是, 换句话说
nap	n. 小睡, 稍睡, 细毛, 孤注一掷 vi. 小睡, 疏忽 vt. 使拉毛, 打盹度过, 预测...为获胜马
narcotic	n. 麻醉药, 镇静剂 a. 麻醉的, 催眠的
narrative	n. 叙述, 故事 a. 叙述的, 叙事的, 故事体的
narrator	n. 讲述者, 叙述者 [法] 陈述者, 叙述者
nasty	a. 污秽的, 下流的, 险恶的
natal	a. 出生的, 诞生的 [医] 分娩的, 生产的; 臀的
national	a. 国家的, 国立的, 全国性的, 民族的 [经] 全国性的, 国家的, 国民的
nationalities	n. 国籍, 民族（nationality的复数）
nationality	n. 国籍, 国家, 民族性 [法] 国家, 民族, 国民
native	n. 本地人, 土产, 当地人 a. 本国的, 与生俱来的, 自然的
natural	n. 白痴 a. 自然的, 自然界的, 本能的, 天然的, 物质的, 正常的, 原始的, 自然数的
nature	n. 自然, 大自然, 本性, 性格, 性质 [医] 自然, 大自然; 本性, 性能
naught	n. 无, 零 a. 无价值的, 无用的
nausea	n. 反胃, 晕船, 恶心, 厌恶 [医] 恶心
nautical	a. 海上的, 航海的, 船员的
naval	a. 海军的, 军舰的, 有舰队的 [法] 海军的, 军舰的, 船的
navigable	a. 可航行的, 可通船的, 适于航行的 [法] 可航行的, 可通航的
navigation	n. 航行, 航海, 导航 [经] 航空, 航海, 航船
neat	a. 整洁的, 巧妙的, 匀称的, 简洁的 n. 牛
necessitate	vt. 迫使, 使成为必需, 需要
neck	n. 脖子, 衣领, 颈 vi. 拥抱, 拥吻, 收缩 vt. 割颈
negation	n. 否定, 反面, 不存在 [医] 否定, 否认
negative	n. 否定, 否定语, 负数, 底片 a. 否定的, 消极的, 负的, 阴性的 n. 负数, 负值 [计] 负数, 负值
neglect	n. 疏忽, 忽略, 漏做 vt. 疏忽, 忽视, 不顾
negligence	n. 疏忽, 粗心大意, 忽视 [经] 疏忽, 过失
negligible	a. 可以忽略的, 不足取的, 无用的 [医] 可不计的, 可忽视的
negotiable	a. 可磋商的, 可转让的, 可通行的 [经] 可流通的, 可转让的
neighboring	a. 附近的, 邻近的, 邻接的
nervous	a. 神经紧张的, 不安的, 神经的 [医] 神经的; 神经质的, 神经过敏的
nets	n. 网（net的复数）
network	n. 网络, 广播网, 网状物 [计] 网络
neurosis	n. 神经症, 神经机能病 [医] 神经机能病, 神经[官能]症
neurotic	n. 神经症患者 a. 神经质的, 神经症的
neutralize	vt. 使中立, 使成中立地带, 使中和, 抵销 vi. 中立化, 变无效, 中和
nevertheless	adv. 然而, 虽然如此 conj. 然而
newspaper	n. 报纸
newspapers	n. 报纸, 报章（newspaper的复数）
nibble	n. 少量食物, 细咬, 轻咬, 啃 v. 一点一点地咬, 细咬, 吹毛求疵 [计] 半字节
nicety	n. 美好, 准确, 精密, 拘泥细节, 纤细
nickel	n. 镍, 镍币, 五分镍币 vt. 镀镍于
night	n. 夜, 夜晚, 晚上, 黑暗, 夜晚的工作 [法] 夜, 黑夜, 黑暗
nightmare	n. 梦魇, 恶梦, 可怕的事物(或情景、人物) [医] 梦魇, 恶梦
nil	n. 无, 全无, 零 [法] 无, 零, 无有
nitrogen	n. 氮 [化] 氮N-2
nobility	n. 贵族, 高尚, 贵族阶级
noble	n. 贵族 a. 高贵的, 高尚的, 贵族的, 辉煌的
noise	n. 噪音, 杂音, 响声, 喧闹 vt. 谣传 vi. 喧闹 [计] 噪声
noisy	a. 嘈杂的, 喧闹的 [机] 噪声的, 嘈杂的
nominal	a. 名义上的, 名字的, 有名无实的, 稍许的 n. 名词性词
nominate	vt. 提名, 任命, 命名 [法] 提名...为候选人, 指定, 推荐
nominee	n. 被提名者, 被任命者 [经] 被指定人
non-drinker	n. 不喝酒的人, 戒酒的人
norm	n. 基准, 模范, 标准, 准则, 平均数 [化] 定额
normal	n. 常态, 标准, 正常, 普通 a. 正常的, 正规的, 标准的, 师范的, 正态的 [计] 标准, 普通
nostalgia	n. 乡愁, 向往过去, 怀旧之情 [医] 怀乡病
notable	n. 著名人士, 值得注意之事物 a. 值得注意的, 显著的
notary	n. 公证人 [经] 公证人, 公证员
notation	n. 记号, 符号表示法, 注释 [计] 记数法
notch	n. 刻痕, 等级, 峡谷 vt. 刻凹痕, 用刻痕计算, 赢得
notebook	n. 笔记本, 手册, 期票簿
notes	n. 票据；注释, 说明（note复数）
nothing	n. 无, 不关紧要之事, 零 adv. 毫不, 决不 interj. 什么也没有, 无
notice	n. 注意, 布告, 通知, 预告, 短评 vt. 注意, 通知, 评论, 提及, 关注 vi. 注意
notify	vt. 通知, 通告, 报告 [计] 通知
notion	n. 概念, 观念, 想法, 打算, 别致的小东西 [经] 概念, 打算, 想法
notorious	a. 声名狼藉的, 臭名昭著的, 众人皆知的
nought	n. 没有, 零, 无
nourish	vt. 滋养, 使健壮, 怀有
nourishment	n. 滋养品, 养料, 营养 [医] 营养, 营养品
novel	n. 小说, 长篇故事 a. 新奇的, 异常的
novelty	n. 新奇, 新鲜, 新奇的事物
November	n. 十一月
novice	n. 新手, 初学者
nowhere	adv. 无处, 到处都无
noxious	a. 有害的, 有毒的, 使道德败坏的 [医] 有害的, 有毒的
nuance	n. 细微差别
nucleus	n. 核心, 核子, 原子核, 起点 [计] 核心程序
nuisance	n. 讨厌的东西, 讨厌的人, 损害 [医] 损害, 讨厌
null	a. 无效力的, 无效的, 无价值的 n. 零, 空, 零位 [计] 空
nullify	vt. 使无效, 废弃, 取消 [化] 使等于零; 作废
numb	a. 麻木的, 失去知觉的 vt. 使麻木, 使昏迷, 使失去知觉
numerical	a. 数字的, 数值的, 以数字表示的, 擅长于计数的 [经] 数字的, 用数字表示的
numerous	a. 很多的, 数目众多的, 多数的 [机] 多数的, 甚多的
nurse	n. 护士, 保姆, 奶妈 vt. 看护, 照顾, 培养 vi. 喂奶, 看护病人
nursery	n. 托儿所, 苗圃, 温床 [医] 婴儿室, 托儿所
nursing	n. 看护, 养育 [医] 护理[法], 喂乳[法]
nurture	n. 养育, 营养物, 培育 vt. 养育, 供给营养物, 教养
nutrition	n. 营养, 营养学 [医] 营养, 营养品
nuts	a. 狂热的, 发狂的, 疯的 interj. 呸, 胡说
nylon	n. 尼龙 [化] 尼龙; 聚酰胺纤维
oar	n. 桨, 桨手, 搅棒 vi. 划桨 vt. 划动
oasis	n. 绿洲, 舒适的地方 [医] 绿洲(沙漠中), 健岛(病变区中的健康组织)
oath	n. 誓约, 誓言, 咒骂 [法] 誓言, 誓约, 宣誓
obedient	a. 服从的, 顺从的, 孝顺的 [法] 服从的, 顺从的, 忠顺的
object	n. 物体, 目标, 目的, 对象, 宾语, 客体 vi. 反对, 抱反感 vt. 提出...来反对 [计] 对象
objection	n. 异议, 反对, 不喜欢, 缺点, 缺陷, 妨碍, 拒绝之理由 [法] 异议, 反对, 抗议
objective	n. 目的, 目标, 宗旨, 宾格, 实物 a. 客观的, 如实的, 无偏见的, 宾格的
objectives	n. 目标( objective的名词复数 ); [光学]（望远镜、显微镜、照相机及其他光学仪器上的）物镜; [语法学]1)。 宾语 2)。 宾格; [军事]出击目标
obligation	n. 义务, 责任, 约束, 契约, 恩惠, 债务 [经] 待付款, 债务, 义务
obligatory	a. 义务的, 必须的, 强制性的 [法] 有拘束的, 强制的, 必须的
oblige	vt. 强制, 施恩惠于, 使感激 vi. 施恩惠, 帮忙
obliging	a. 乐于施惠的, 体贴的, 有礼貌的
oblique	a. 斜的, 倾斜的, 间接的, 不光明正大的, 躲躲闪闪的 [医] 斜的
oblivious	a. 遗忘的, 健忘的, 不知不觉的 [法] 忘却的, 健忘的, 不在意的
oblong	n. 长方形, 长椭圆形 a. 长方形的, 长椭圆形的
obnoxious	a. 可憎的, 使人不愉快的, 令人讨厌的
obscene	a. 淫秽的, 猥亵的, 讨人厌的, 可憎的 [法] 猥亵的, 海洋的, 污秽的
obscure	a. 模糊的, 昏暗的, 难解的, 晦涩的, 偏僻的, 微贱的, 无名的 vt. 使变暗, 隐藏, 使变模糊, 使难解
observance	n. 观察, 遵守, 仪式, 风俗习惯 [法] 遵守, 奉行, 惯例
observation	n. 观察, 注意, 观测, 观察力 [化] 观察
observatory	n. 天文台, 气象台, 了望台
observe	vt. 觉察到, 遵守, 注意到, 庆祝 vi. 注意, 评论
obsess	vt. 迷住, 使困扰
obsession	n. 困扰, 困扰人的情绪 [医] 强迫观念
obsolete	a. 荒废的, 成废物的, 陈旧的, 老式的 n. 废词, 废物
obstacle	n. 障碍, 妨害物, 阻碍
obstinate	a. 倔强的, 顽固的, 不让步的
obstruct	vt. 阻隔, 妨碍, 阻塞, 遮没 vi. 设障碍
obvious	a. 明显的, 明白的, 显然的, 平淡无奇的
occasion	n. 场合, 时机, 机会, 诱因, 理由 vt. 惹起, 引起
occupants	n. 居住者；购买者；租赁人（occupant的复数）
occupation	n. 职业, 占有, 占有期, 占领, 占领军 [经] 占有, 占用, 职业
occupational	a. 职业的, 军事占领的 [医] 职业的
occupy	vt. 占领, 占(时间、空间等), 住进, 担任, 使从事, 使全神贯注 [法] 占领, 占据, 占有
occur	vi. 发生, 被想到, 存在
occurrence	n. 发生, 事件, 出现 [医] 发生
ocean	n. 海洋, 广阔, 许多, 一大片 [法] 海洋, 海
October	n. 十月
odd	a. 奇数的, 古怪的, 剩余的, 零散的, 各种各样的, 少量的 n. 奇特的事物, 怪人 [计] 奇数, 奇校验, 光数据数字转换器
odds	n. 可能性, 几率, 机会, 胜算, 不平等
odour	n. 气味, 臭气, 香气, 味道, 迹象, 名誉, 声誉 [医] 气味
Odyssey	n. 奥德赛(古希腊史诗)
offence	n. 犯罪, 冒犯, 违反, 罪过, 过错, 攻击 [法] 犯法, 罪过, 过错
offend	v. 犯罪, 冒犯, 违反, 进攻
offer	n. 给予(物), 出价, 提议, 意图, 报价 vt. 提供, 出价, 奉献, 试图, 使出现, 演出 vi. 出现, 献祭, 提议, 求婚
office	n. 办公室, 部, 公职, 职责 [化] 办公室
officer	n. 军官, 主管, 官员, 公务员 vt. 指挥
offset	n. 抵消, 把...并列, 旁系, 支管, 用胶印法印 vt. 弥补, 抵消, 胶印 vi. 装支管 n. 偏移量 [计] 偏移量
offshore	a. 海面的, 吹向海面的, 近海的 adv. 向海面
offspring	n. 子孙, 后代, 产物 [法] 后辈, 子孙, 后裔
ohp	abbr. overhead projection 高架发射, 顶置防护; oxygen at high pressure 高压氧气
oil	n. 油, 石油, 油画颜料 vt. 涂油于, 使融化成油状, 加油于 vi. 加燃油, 融化
Olympic	a. 奥林匹亚的, 奥林匹斯山的, 强有力的, 巨大的
omen	n. 预兆, 前兆, 征兆 vt. 预示, 有...的前兆, 显出...的预兆
ominous	a. 恶兆的, 不吉利的, 预兆的
omit	vt. 省略, 删除, 疏忽, 遗漏 [化] 省略
on	prep. 在...之上 adv. ...上去 a. 正起作用的 [计] 打开
once	adv. 一次, 曾经, 一旦 conj. 一旦, 一经 n. 一次 a. 从前的
one	n. 一(个) pron. 一, 任何人 num. 一, 一个 a. 一致的, 完整的
ongoing	a. 前进的, 进行的, 不间断的 n. 前进, 发展
online	[计] 联机
onlooker	n. 旁观者, 袖手旁观者
onset	n. 开始, 攻击, 进攻 [医] 起始, 开始
opaque	n. 不透明物 a. 不透明的, 不传热的, 不传导的, 阴暗的 [计] 白底
open-book	a. 开卷的
opening	n. 开始, 口子, 穴, 揭幕 a. 开始的
opinion	n. 意见, 评价, 主张 [经] 意见
opponent	n. 对手, 敌手, 反对者 a. 敌对的, 反对的, 对面的
opportunities	n. 机会( opportunity的名词复数 ); 适当的时机; 条件; 就业（或晋升、进步等）的良机
opportunity	n. 机会, 时机
oppose	vt. 反对, 以...对抗, 抗争 vi. 反对
opposite	a. 相对的, 相反的, 对面的 prep. 对面 n. 对立面
oppress	vt. 压迫, 压抑, 使烦恼
opt	vi. 选择
optic	a. 眼睛的, 视觉的, 光学的 n. 镜片
optical	a. 眼睛的, 视觉的, 光学的 [机] 光学上的, 光学的
optimism	n. 乐观主义, 乐观, 乐天 [医] 乐观主义, 乐观
optimum	n. 最适条件, 最佳效果 a. 最优的, 最适宜的
option	n. 选择权, 挑选, 选项 [计] 选项
optional	a. 可选择的, 随意的 [化] 选购的
options	n. 选择；期权；选择项（option的复数）
oral	n. 口试 a. 口头的, 口述的, 口部的
orbit	n. 轨道, 常轨, 眼眶 vt. 绕...轨道而行 vi. 进入轨道, 盘旋
orchard	n. 果园, 果树林
orchestra	n. 管弦乐队, 乐队演奏处
ordeal	n. 严酷考验, 痛苦经历, 煎熬 [法] 神裁判法, 严酷的考验, 痛苦的经验
order	n. 次序, 规则, 命令 vi. 命令, 定货 vt. 整理, 命令, 定购 n. 顺序, 阶数 [计] 顺序, 阶数
orderly	a. 有秩序的, 整齐的, 值班的 n. 护理员, 清道夫, 传令兵, 勤务兵 adv. 依次地, 顺序地
ordinary	a. 平常的, 普通的, 平凡的 n. 平常的人(或事)
ore	n. 矿石 [经] 矿
organ	n. 风琴, 器官, 元件, 机构, 机关 [电] 风琴
organic	a. 器官的, 有机的, 组织的, 根本的 [医] 器官的, 有生命的, 有机的, 器质的
organism	n. 生物, 有机体, 社会组织 [医] 生物[体],[有]机体
organization	n. 组织, 结构, 团体, 体制 [医] 组织, 机构, 机化(血栓或坏死组织)
organizer	n. 组织者, 编制者, 创立者, 组织导体 [医] 组织导体, 机化中心(胚)
oriental	n. 东方人, 亚洲人 a. 东方诸国的, 亚洲的, 东方的
orientation	n. 定方位, 适应, 向东方 n. 方向 [计] 方向
origin	n. 起源, 起因, 出身, 开端 [计] 原点; 起始地址; 信件来源的相关数据
original	a. 最初的, 原始的, 有创意的 n. 原物, 原作
originate	vt. 创始, 发明, 发起 vi. 发源, 发生, 起航 [计] 发自
ornament	n. 装饰, 点缀品, 教堂用品 vt. 装饰, 修饰
orthodox	a. 正统的, 传统的, 惯常的
oscillate	vi. 振动, 彷徨, 犹豫 vt. 使振动, 使动摇
ostensible	a. 表面的, 假装的, 看得出的 [经] 表面的, 诡称的
ostentation	n. 虚饰, 虚有其表, 卖弄
otherwise	adv. 否则, 不同地, 别的方式
oust	vt. 逐出, 罢黜, 剥夺, 驱逐 [法] 驱逐, 剥夺, 免职
outbreak	n. 爆发, 暴动 [医] 暴发
outcast	a. 被逐出的, 被遗弃的, 无家可归的 n. 被驱逐的人, 流浪者
outcome	n. 结果, 出口
outcry	n. 尖叫, 倒彩, 强烈抗议, 喊价 vi. 喊叫 vt. 叫得比...响
outdated	a. 旧式的, 落伍的, 过时的
outdo	vt. 超越, 胜过, 战胜
outfit	n. 用具, 配备, 机构 vt. 配备, 供应 vi. 得到装备
outlaw	n. 被剥夺法律保护的人, 罪犯 vt. 使...失去法律保护, 将...逐出社会, 宣告非法, 取缔
outlet	n. 出口, 发泄方法, 市场 [医] 出口
outline	n. 大纲, 轮廓, 概要 vt. 描画轮廓, 描述要点 n. 大纲, 分级, 轮廓 [计] 大纲, 分级, 轮廓
outlying	a. 在外的, 边远的, 偏僻的, 题外的
output	n. 输出, 产品, 产量 [计] 输出
outrageous	a. 暴虐的, 极无礼的, 可恶的
outright	a. 率直的, 完全的, 总共的, 直率的 adv. 完全地, 率直地, 立刻地, 一直向前
outset	n. 着手, 开头, 最初
outskirts	n. 近郊, 市郊
outspoken	a. 直言无讳的, 坦率的, 坦白无隐的
outstrip	vt. 追过, 胜过, 凌驾
outweigh	vt. 比...重, 比...重要, 比...有价值
oval	n. 椭圆形 a. 卵形的, 椭圆形的
ovation	n. 热烈欢迎, 大喝采, 小凯旋式
overall	a. 全部的, 全体的, 从头至尾的, 一切在内的 adv. 从头到尾, 总的说来 n. 罩衫, 工作服
overcome	vt. 战胜, 克服, 胜过 vi. 得胜
overdue	a. 过期的, 未兑的, 迟到的, 早就成熟的 [经] 过期未付的
overflow	n. 溢值, 超值, 泛滥 v. (使)泛滥, (使)溢出, (使)充溢 [计] 上溢; 溢出
overhaul	vt. 分解检查, 翻修, 精细检查, 彻底革新 n. 分解检查, 精细检查, 大检修
overhead	n. 经常开支, 普通用费, 天花板 a. 在头上的, 高架的 adv. 在头顶上, 在空中, 在高处, 从头到脚全部没入地 [计] 总开销; 额外开销
overhear	vt. 无意中听到, 偷听
overlap	n. 重叠, 重复, 部分的同时发生 vt. 重叠, 重复, 与...同时发生 vi. 迭盖, 部分的同时发生 [计] 重叠
overlook	vt. 俯瞰, 远眺, 没注意到 n. 眺望, 俯瞰到的景色
override	vt. 推翻, 无视, 对...有最后发言权, 制服, 践踏, 奔越过 [经] 代理佣金, 代销佣金
overrule	vt. 统治, 威压, 打败, 驳回 [法] 否决, 驳回, 批驳
overrun	n. 蔓延, 风行一时, 超过限度 vt. 蔓延, 蹂躏, 超过, 泛滥 vi. 泛滥, 超载限度 [计] 超限
overseas	a. 海外的, 国外的 adv. 在海外, 在国外
oversee	vt. 向下看, 了望, 监督, 偷看到 [法] 监察, 监督, 俯瞰
overt	a. 明显的, 公然的, 蓄意的 [法] 明显的, 公开的
overtake	vt. 赶上, 突然降临于, 压倒, 代替
overthrow	n. 推翻, 瓦解, 倾覆 vt. 打倒, 推翻, 倾覆
overture	n. 主动表示, 事件的开端, 序言, 提议, 提案, 初步交涉 vt. 提议, 为...奏前奏曲
overwhelm	vt. 淹没, 受打击, 制服, 压倒, 使不知所措 [法] 打翻, 倾覆, 覆盖
overwrought	a. 过分劳累的, 过度紧张的, 神经质的, 过度兴奋的, 过分推敲的, 不自然的
owe	vt. 亏欠, 负...债, 归功于, 怀有, 应给予, 感恩 vi. 欠钱
ownership	n. 所有权, 物主身份 [经] 所有权, 所有制
Oxford	n. 牛津, 牛津大学
oxide	n. 氧化物 [医] 氧化物
pace	n. 速度, 步调, 步法 vi. 踱步, 缓慢走 vt. 用步测, 踱步于
pacific	n. 太平洋 a. 太平洋的, 太平洋沿岸的, 爱好和平的, 安静的, 平息的
pacify	vt. 使平静, 安慰, 绥靖, 使服从
package	n. 包裹, 套装软件, 包, 包装用物, 程序包 vt. 包装, 打包 a. 一揽子的 [计] 包, 软件包, 包装
pad	n. 填补, 衬垫, 印色盒, 路 vt. 填补, 走, 夸大 vi. 步行 [计] 焊接点; 包装配/拆卸
paddle	n. 桨, 划桨, 明轮翼 vi. 划桨, 戏水, 涉水 vt. 用桨划, 划船运送, 搅, 拌
pageant	n. 盛会, 游行, 虚饰, 露天表演
pages	n. 页数；青年侍从（page的复数）
painstaking	n. 辛苦, 苦心, 工夫 a. 辛苦的, 勤勉的, 小心的
painting	n. 画, 绘画, 油漆 [化] 涂漆
pair	n. 一双, 一对, 一副 v. (使)成对
pal	n. 朋友, 伙伴, 同志, 同谋 vi. 交友, 结伴
palace	n. 宫, 宫殿, 华丽大厦
palatable	a. 美味的, 好吃的, 可口的 [医] 适口的, 味美的
palm	n. 手掌, 棕榈, 胜利 vt. 与...握手, 藏...于掌中
palpitate	vi. 悸动, 心跳, 发抖 [医] 心悸
pamper	vt. 放纵, 使吃饱, 使过量
pamphlet	n. 小册子, 活页文选
panel	n. 嵌板, 仪表板, 专题讨论小组, 全体陪审员 vt. 嵌镶板
panic	n. 恐慌, 惊慌 a. 惊慌的, 没有理由的, 恐慌的 vt. 使惊慌, 使狂热 vi. 惊慌
panorama	n. 全景, 全貌, 概论, 范围
pant	n. 喘息, 悸动 vi. 喘息, 渴望 vt. 气喘吁吁地说
pants	n. 裤子, 长裤, 短衬裤, 女式运动短裤
paper	n. 纸, 文件, 文章, 报纸, 证券, 证件 vt. 用纸糊, 贴壁纸于, 用纸包装 vi. 贴壁纸 a. 纸做的, 纸上的
papers	n. 文件, 官方文件 [法] 票证, 证券, 纸币
parachute	n. 降落伞 vi. 跳伞
parade	n. 游行, 炫耀, 阅兵 v. 游行, 炫耀, (使)列队行进
paradise	n. 天堂, 乐园, 伊甸园
paradox	n. 似非而是的论点, 自相矛盾的话, 悖论, 怪人怪事 [化] 佯谬
parallel	n. 平行, 对比, 相匹敌之物 a. 平行的, 相似的 vt. 与...平行, 与...相似, 相比, 使平行 [计] 并联; 并行
paralyse	vt. 使麻痹, 使瘫痪, 使无力, 使气馁, 终止 [医] 使麻痹, 使瘫痪
paralysis	n. 麻痹, 停顿, 瘫痪 [医] 麻痹, 瘫痪
paramount	n. 首长, 最高当局 a. 最重要的, 最高的, 至上的
paranoia	n. 偏执狂, 多疑症 [法] 妄想狂, 偏执狂
paraphernalia	n. 随身用具
paraphrase	n. 释义, 解述, 改写 vt. 改写, 解述 vi. 释义, 意译
parasite	n. 寄生生物, 寄生虫, 食客 [医] 寄生物; 寄生胎
parcel	n. 包裹, 部分, 片 vt. 分配, 打包 a. 部分的 adv. 局部地
parent	n. 父母, 父母亲, 根源 [法] 父亲, 母亲, 根源
parental	a. 父母亲的, 做双亲的, 作为渊源的 [医] 父母的, 双亲的
parents	n. 父母；双亲（parent的复数）
park	n. 公园, 停车处 vt. 停车, 置于 vi. 停车
parking	n. 停车 a. 停车的
parliament	n. 国会, 议会 [法] 会议, 国会, 议院
parody	n. 打油诗文, 诙谐的模仿诗文, 拙劣的模仿 vt. 拙劣模仿, 作模仿诗文
part	n. 部分, 局部, 零件, 要素, 等分, 职责, 角色, 部位 vt. 分开, 分离, 断绝, 区别, 分配 vi. 分开, 断裂, 分手 a. 部分的, 局部的 adv. 部分地, 有些
part-time	a. 兼任的, 半工半读的, 部分时间的 adv. 部分时间, 兼任地
partial	a. 部分的, 偏袒的, 偏爱的 n. 分音
participants	n. 参加者, 参与者; 参加者, 参与者( participant的名词复数 ) a. 有份的, 参与的
participate	vi. 参加, 分享, 参与, 带有 vt. 分享, 分担
particle	n. 颗粒, 粒子, 质点, 极小量 [化] 粒子; 质点
parties	n. 当事人；聚会；党派；政党机关；同行者（party的复数）
partisan	n. 党羽, 虔诚信徒, 同党, 游击队员 a. 党派的, 偏袒的, 效忠的, 献身的, 盲目推崇的
partition	n. 分割, 隔离物, 隔墙, 财产分割 vt. 区分, 瓜分, 隔开, 分割 [计] 分区; 划分
party	n. 宴会, 党, 政党, 团体, 当事人, 聚会 v. 举办聚会
pass	n. 经过, 要隘, 途径, 通行, 护照, 及格 vt. 经过, 越过, 通过, 批准, 度过, 传递, 忽略 vi. 经过, 变化, 流通, 及格, 宣判, 终止, 消逝, 被忽略, 不叫牌, 传递 [计] 遍
passage	n. 通道, 通过, 移居, 航行, 一段, 走廊 vi. 通过, 经过, 航行, 横渡, 争吵 vt. (使)马以斜横步前进, 使传代
passengers	n. 乘客( passenger的名词复数 ); 旅客; 白吃饭的人; 闲散人员
passion	n. 激情, 酷爱, 热爱, 强烈感情, 耶稣受难(故事)
passive	a. 消极的, 被动的, 冷漠的, 顺从的, 无源的 [医] 被动的
passport	n. 护照, 手段, 通行证 [法] 通行证, 护照
pastime	n. 消遣, 娱乐, 游戏
pasture	n. 牧场, 草地, 牧草 vt. 放牧 vi. 吃草
patch	n. 片, 补缀, 碎片, 斑, 傻瓜 vt. 补缀, 掩饰, 拼凑, 平息 [计] 修补; 拼凑
patent	n. 专利权, 许可证, 执照, 专利品, 素质 a. 专利的, 特许的, 显著的, 新奇的 vt. 取得...的专利权, 请准专利
paternity	n. 父亲身份, 父系血统, 创始人(身份), 来源, 出处 [医] 父权, 亲权; 父系
pathetic	a. 悲哀的, 可怜的, 感伤的, 差劲的 [医] 感情的
pathos	n. 伤感力, 感伤, 悲怅, 同情, 偶然因素, 哀婉动人的词句
patients	n. 病人（patient的复数形式）
patriotism	n. 爱国心, 爱国精神, 爱国主义
patrol	n. 巡逻, 巡逻员, 侦察队 v. 巡逻, 巡视
patron	n. 赞助人, 顾客, 保护人 [法] 保护人, 庇护人, 赞助人
pattern	n. 模范, 典型, 式样, 样品, 图案, 格调, 模式 vt. 模仿, 仿造, 以图案装饰 vi. 形成图案 [计] 模式, 图案
patterns	n. 模式（pattern的复数形式）
pave	vt. 铺设, 安排, 铺满, 为...铺路 [化] 铺设
pavement	n. 路面, 人行道, 铺面路, 铺路材料
pay	n. 薪资, 付款, 补偿 vt. 支付, 付清, 补偿, 偿还, 对...有利, 为...涂防水物 vi. 付款, 付出代价, 偿还, 得到报应, 获得好处
payable	a. 可付的, 到期的, 应付的, 有利益的 [经] 应付的
payment	n. 付款, 支付的款项(或实物), 偿还, 报应, 惩罚 [经] 支付, 缴纳, 支付款额
peasants	n. 农民( peasant的名词复数 ); 农夫; 佃农; 粗俗的人
peculiar	a. 奇特的, 罕见的, 特殊的, 特别的 n. 特有财产, 特权
pedal	n. 踏板, 脚蹬子 a. 脚的, 脚踏的 vt. 用脚踏动 vi. 踩踏板, 骑车
pedestrian	n. 行人, 步行者 a. 人行的, 徒步的, 呆板的, 通俗的, 平淡无奇的
peel	n. 皮, 外壳 vt. 削...皮, 剥去...的壳 vi. 蜕皮, 剥落, 脱皮, 脱去衣服
peer	n. 同等的人, 匹敌, 贵族 vi. 凝视, 窥视, 费力地看, 隐现 vt. 与...同等, 封为贵族
penalty	n. 处罚, 刑罚, 罚款, 罚球, 报应, 不利结果, 妨碍 [经] 罚金(款), 违约金
pence	pl. (非正式)copper便士, (美)分, 分币
pendulum	n. 钟摆, 摇锤, 摇摆不定的事态(或局面) [化] 摆
penetrate	vt. 穿透, 刺穿, 渗透, 看穿, 洞察, 了解, 使充溢 vi. 刺入, 看穿, 渗透, 打进
penicillin	n. 盘尼西林, 青霉素 [化] 青霉素
pennies	pl. (非正式)copper便士, (美)分, 分币
penny	n. 便士, 一分, 小钱, 点滴 [经] 便士
pension	n. 养老金, 退休金, 津贴, 年金, 抚恤金, 膳宿学校, 膳宿费 vt. 发给退休金, 用津贴拉拢
per	prep. 每一, 通过, 经, 按照 [经] 每, 按照
perceive	v. 感觉; 认识, 理解; 察觉到, 意识到, 注意到
percent	n. 百分比, 百分数, 部分 [机] 百分率
percentage	n. 百分比, 比率, 部分, 可能性 [计] 百分比
perceptible	a. 可察觉的, 能感觉得到的, 看得见的
perception	n. 知觉, 感觉, 领悟力, 获取 [医] 知觉
percussion	n. 敲打, 碰撞, 叩击, 叩诊, 击发, 打击, 打击乐器组 [医] 叩诊
perennial	a. 常年的, 长期的, 反复的 [医] 多年生的
perfect	n. 完成时 a. 完美的, 完好的, 理想的, 熟练的, 精确的, 完成式的 vt. 使完美, 修改, 使精通, 改善, 使熟练
performance	n. 施行, 工作情况, 成绩, 行为, 表现, 演出 [电] 绩效, 性能
perfume	n. 香水, 香气, (悦人的)气氛, 美名 vt. 洒香水于, 薰香, 使充满香气
peril	n. 危险, 冒...之险, 险境, 险因 vt. 置...于险境, 冒险, 危及
perimeter	n. 周长, 周界, 边缘 [医] 周, 周边, 周界线; 周长; 视野计
period	n. 时期, 节段, 节, 句点, 学时, 周期 a. 当时特有的, 过去某段时期的 interj. 就是这话, 就是这么回事
periodical	n. 期刊 a. 定期出版的, (有关)期刊的, 间歇(性的), 周期的, 定期的
periodically	adv. 定期, 循环, 间歇, 周期, 定期刊行, 期刊
periphery	n. 外围, 边缘地区, 圆周 [医] 外周, 周围
periscope	n. 潜望镜(镜头) [化] 潜望镜
perish	vi. 毁灭, 丧生, 凋谢, 颓丧, 死亡, 腐烂 vt. 毁坏, 使麻木, 使丧生, 耗尽
perishable	a. 易腐坏的, 会枯萎的, 易毁灭的, 不经久的 n. 易腐坏的东西
Perks	n. 特权；额外津贴（perk的复数）；特别待遇 n. (Perks)人名；(英)珀克斯；(法)佩尔克 v. 打扮；使振作；昂首挺胸（perk的第三人称单数）
permanent	a. 永久的, 不变的, 固定的, 持久的 n. 烫发 [计] 永久的
permeate	vt. 弥漫, 渗透, 充满, 影响, 感染 vi. 透入, 散布
permissible	a. 可允许的, 可容许程度的 [机] 容许, 允许
permit	n. 许可证, 许可, 执照, 通行证 vt. 允许, 容许, 可能, 使放手做 vi. 容许, 给以机会, 提供可能
perpendicular	n. 垂直线, 垂直的位置, 直立(姿势), 刚正, 垂规 a. 垂直的, 直立的, 陡峭的
perpetual	a. 永久的, 不断的, 无期限的, 没完没了的, 四季开花的 [经] 永远的, 终身的, 持续的
perplex	vt. 使困惑, 使复杂化, 使为难 [法] 困惑, 使复杂化, 使纠缠不清
perplexity	n. 困惑, 混乱状态, 使人困惑的事物
persecute	vt. 迫害, 虐待, 困扰, 同...捣乱 [法] 迫害, 虐待, 烦扰
persevere	vi. 坚持, 孜孜不倦, 不屈不挠, (辩论中)固执己见
persist	vi. 坚持, 固执, 持续, 坚称 [经] 持续
person	n. 人, 人身, 人称 [法] 人, 法人, 人身
personal	a. 私人的, 涉及隐私的, 有人性的, 人称的, 亲自的, 身体的 [医] 人的; 个人的, 自身的
personality	n. 个性, 人格, (团体、地方、国家)特有特性, 名人 [医] 人格; 个性
personnel	n. 人员, 人事部门, 人事科(处) [经] 人事, 全体人员, 职工
perspective	n. 远景, 透视感, (观察问题的)视角, 透视法, 看法, 透视图 a. 透视的, 透视法的 [计] 透视
perspire	v. 出汗, 流汗, 分泌, 渗出
pertain	vi. 从属于, 关于, 涉及, 附属, 适合, 相称 [法] 属于, 从属, 附属
pertinent	a. 相关的, 中肯的, 切题的 [法] 恰当的, 有关的
perturb	vt. 扰乱, 使混乱, 使心绪不宁
pervade	vt. 弥漫于, 遍及于, 流行于, 蔓延, 渗透于, 充满
perverse	a. 乖张的, 故意作对的, 有悖常情的, 执迷不悟的, 歪曲的, 错误的, 不正当的 [法] 邪恶的, 罪恶的:堕落的, 不合法的
pervert	vt. 使堕落, 使反常, 歪曲, 滥用, 使左右颠倒, 唆使...性变态 n. 堕落者, 行为反常者, 背教者, 性欲反常者
pessimism	n. 悲观, 悲观情绪, 悲观主义 [医] 悲观主义
pester	vt. 不断打扰, 纠缠
pesticide	n. 杀虫剂 [化] 农药
pet	n. 宠物, 受宠爱的人, 宠坏的孩子, 不悦, 生气 a. 宠爱的, 表示亲昵的, 养着观赏的, 特别珍爱的, 格外的 vt. 宠爱, 溺爱, 抚摸 vi. 拥抱, 爱抚, 生气, 发脾气
petal	n. 花瓣 [医] 花瓣
petition	n. 请愿, 诉状, 陈情书, 申请, 祈求, 祷文 v. 正式请求, 恳求, 请愿
petrol	n. 汽油 [经] 汽油, 挥发油, 石油
petroleum	n. 石油 [化] 石油
PETS	abbr. 公共英语等级考试（Public English Tset System）
petty	a. 琐碎的, 小规模的, 小气的, 委琐的 [经] 小额的, 微小的, 小规模的
pharmaceutical	a. 药学的, 制药的, 药用的, 药物的, 药剂师的, 药师的 n. 药品, 成药, 药剂
pharmacy	n. 药房, 配药学, 制药业 [医] 药学, 药剂学, 调剂学, 药房
phase	n. 时期, 局面, 方面, 位相, 相, 阶段 vt. 使调整相位, 使定相, 使一致, 逐步执行, 实行 [计] 阶段
phd	abbr. 哲学博士学位（Doctor of Philosophy）
phenomenal	a. 现象的, 能知觉的, 异常的, 显著的, 惊人的
phenomenon	n. 现象, 迹象, 表现, 奇迹, 奇才 [化] 现象
phobia	n. 恐怖病, 恐惧症, 惧怕, 憎恶 [医] 恐怖[症]
phone	n. 电话, 受话器, 耳机 vt. 打电话给 vi. 打电话
phone-in	n. 观众/听众通过电话参与讨论或提问的电视节目/广播节目
phonetic	a. 语音的, 语音学的, 表示语音的, 语音差异的 [医] 语音的
photocopies	n. 影印本( photocopy的名词复数 ); 复印件
photocopy	n. 影印, 复印件 v. 影印
photograph	n. 相片, 照片, 逼真的描绘 v. 照相, 摄影
photographs	n. 照片；逼真的描绘（photograph的复数）
photojournalism	n. 摄影新闻工作, 摄影报道
photos	n. 照片, 图片；相册（photo的复数形式）
physical	a. 身体的, 物质的, 自然的, 物理学的, 好色的 n. 体格检查
physically	adv. 按自然规律, 完全地, 实际上, 真正地, 身体上地
physician	n. 医师, 内科医师, 解除痛苦者 [医] 主治医师
physiological	a. 生理学的, 生理学上的, 生理机能的 [医] 生理学的, 生理的
physique	n. 体格, 体形 [医] 体格
pianist	n. 钢琴家, 钢琴演奏者
piano	n. 钢琴
pick	n. 精选, 选择, 掘, 精华, 牙签, 鹤嘴锄 v. 摘, 掘, 凿, 挖, 挑选 [计] 拾取
picnic	n. 野餐, 远足, 愉快的经历 vi. 去野餐, 远足
picture	n. 图画, 照片, 景色, 美丽如画的人(或物), 化身, 生动的描述, 想像, 形象思维 vt. 画, 拍摄, 用图说明, 描写, 想像 [计] 图象; 形象; 字形
pictures	n. 电影院
picturesque	a. 生动的, 如画的, 独特的, 别致的, 栩栩如生的
pie	n. 馅饼, 财富, 总额, 贪污受贿, 杂乱, 喜鹊 [计] 饼图
piecemeal	adv. 一件一件地, 逐个地, 零碎地 a. 一片一片的, 逐渐的, 零碎的 n. 断片
pier	n. 码头, 桥墩, 支框, 防波堤 [医] 桥基, 基牙
pierce	vt. 刺穿, 穿透, 打眼于, 洞悉, (声音)响彻, (亮光)照进, 深深地打动 vi. 刺入, 穿入, 透入, 进入
piety	n. 虔诚, 孝敬, 虔诚的行为
pigment	n. 色素, 色质, 颜料 [化] 颜料
pilgrim	n. 旅行者, 朝圣者, 香客 vi. 朝圣
pillar	n. 柱子, 栋梁, 台柱, 重要的支持者 [医] 柱, 脚
pillow	n. 枕头, 靠垫, 枕状岩 vt. 作...的枕头, 垫, 枕于 vi. 靠在枕上
pills	n. 丸剂；药丸（pill的复数）
pilot	n. 飞行员, 领航员, 航船者, 导向器, 驾驶仪, 向导, 领导人 vt. 领航, 驾驶, 引导, 试用 a. 引导的, 控制的, 试点的 [计] 引导
pimple	n. 丘疹, 小脓疱 [医] 丘疹, 小脓疱
pin	n. 大头针, 针, 别针, 栓, 销子, 图钉, 插头, 管脚, 品(液量单位) vt. 将...用针别住, 钉住, 压住, 牵制, 使不能动, 归罪于 a. 针的, 销子的, 闩的
pinch	n. 捏, 拧, 撮, 少量, 收缩, 挤压, 夹痛, 苦恼, 逮捕, 指控, 匮乏, 紧急关头 vt. 捏, 拧, 掐, 挤压, 修剪, 使困苦, 使萎缩, 节制, 少量加入, 逮捕, 勒索 vi. 收缩, 节省, 挤压, 引起苦恼
pine	n. 松树, 松木 vi. 消瘦, 憔悴, 痛苦, 怀念, 渴望 [计] 邮件程序
pink	n. 粉红色, 石竹花, 化身, 典范, 头面人物, 极度 a. 粉红的, 石竹科的, 比较激进的, 脸色发红的, 精致的, 有点下流的 vt. 刺, 扎, 刺痛, 射伤, 使面红耳赤, 使变粉红色 vi. 变粉红色
pinnacle	n. 小尖塔, 尖峰, 高峰, 极点 vt. 造小尖塔, 置于尖顶上
pinpoint	n. 极小之物, 针尖, 立锥之地, 精确位置 vt. 精确地找到, 准确地轰炸, 刺穿, 准确描述, 使突出, 强调 a. 针尖的, 极微的, 精确的, 详尽的, 精确定位的
piracy	n. 海盗行为, 海上劫掠, 剽窃, 著作权侵害, 非法翻印 [法] 海盗行为, 海上掠夺, 海盗罪
piston	n. 活塞, 活塞阀键 [医] 活塞(如注射器的)
pit	n. 深坑, 矿井, 果核, 地窖, 深渊, 绝境, 陷阱 vt. 窖藏, 使凹下, 使有麻点, 去...之核, 使留疤痕, 使相斗, 使竞争 vi. 起凹点, 凹陷
pitch	n. 程度, 坡度, 顶点, 前倾, 倾斜, 投掷, 音高, 螺距, 节距, 摊位, 树脂, 沥青 vt. 投, 掷, 向前倾跌, 扎营, 竭力推销, 为...定调, 定位于, 用沥青涂 vi. 搭帐篷, 投掷, 向前跌, 猛然摔倒, 坠落, 倾斜 [计] 孔距
pivot	n. 枢轴, 支点, 旋转运动, 中枢, 关键人物 a. 枢轴的, (如)在枢轴上转动的 vi. 在枢轴上转动, 随着转移 vt. 装枢轴于, 以...为中心旋转 [计] 程序员交互验证和编制工具, 数据透视表
placard	n. 公告, 布告, 小牌, 海报 vt. 公布, 布告, 张帖, 贴海报于
place	n. 地方, 地点, 位置, 住所, 座位, 地位, 处境, 特权, 空间, 余地, 职务, 位 vt. 放置, 寄予, 认出, 评定, 任命 vi. 名次列前
placement	n. 放置, 布置, 工作安排, 编班, 定位球 [计] 放置
places	n. 地点；位置；[数]位数（place的复数）
placid	a. 平静的, 温和的, 沉着的, 平稳的
plagiarize	v. 剽窃, 抄袭
plague	n. 瘟疫, 天罚, 麻烦, 灾祸 vt. 折磨, 使苦恼, 使得灾祸
plaintive	a. 悲哀的, 哀伤的, 伤心的, 表示痛苦的
plan	n. 计划, 方案, 策略, 方法, 进度表, 程序表, 平面图, 设计图, 轮廓, 示意图 vt. 计划, 设计, 意欲 vi. 订计划
planetarium	n. 行星仪, 天文馆, 天象图
plank	n. 厚木板, 支架, 木板制品, 冲浪板, 救急物, 政纲条目 vt. 在...上铺板, 撂下, 立即付款
plankton	n. (总称)浮游生物 [医] 浮游生物
planner	n. 计划者, 设计者, 安排者 [机] 刨床机
planners	n. 规划者, 策划人( planner的名词复数 )
planning	n. 计划的制订, 策划, 设计, 规划 [计] 计划, 规划
plant	n. 植物, 作物, 工厂, 树枝, 生长, 设施, 成套设备 vt. 种植, 栽培, 播种, 培养, 安置, 殖民于, 使位于 vi. 种植
plantation	n. 种植园, 大农场, 植树造林, 新开垦地 [医] 栽植(如牙或其他组织的植入、再植和移植)
planting	n. 种植, 栽培, 播种, 人工林, 花圃, 苗圃
plants	n. 植物；工厂（plant的复数形式）
plaster	n. 石膏, 灰泥, 安慰(缓解)用品, 膏药 vt. 涂以灰泥, 敷以膏药, 掩饰, 使平服, 彻底击败, 减轻, 粘贴
plastic	n. 塑料, 可塑体, 可塑性物质 a. 塑料的, 塑造的, 有可塑性的, 造型的, 易受影响的, 有创造力的
plateau	n. 高地, 高原, (上升后的)稳定水平 [医] 高原, 平顶, 坪
platform	n. 站台, 月台, 讲台, 论坛, 平台 [计] 平台
platitude	n. 单调, 平凡, 陈腐, 陈词滥调
plausible	a. 貌似真实的, 貌似合理的, 说得煞有其事的 [法] 花言巧语的, 似乎有理的
player	n. 竞赛者, 上场队员, 游戏者, 演员 [经] 交易者
playground	n. 运动场, 操场, 度假胜地, 活动场所
plea	n. 恳求, 辩解, 抗辩, 诉讼, 请愿, 托词 [法] 抗辩, 申诉案件, 答辩
plead	vi. 辩护, 恳求 vt. 为...辩护, 提出...借口, 托称, 恳求
pleasant	a. 愉快的, 可爱的, 活泼的, 亲切的
pleasure	n. 快乐, 愉快, 令人高兴的事, 娱乐, 希望 v. (使)高兴
pledge	n. 诺言, 保证, 誓言, 抵押, 信物, 保人, 祝愿 vt. 许诺, 保证, 使发誓, 抵押, 典当, 举杯祝...健康
pliable	a. 易弯的, 柔顺的, 圆通的
plight	n. 困境, 窘境 vt. 宣誓, 保证
plot	n. 小块土地, 地区图, 图, 阴谋, 情节 vt. 划分, 绘图, 密谋 vi. 密谋, 策划 [计] 绘制
plough	n. 犁, 犁过的地 vi. 用犁耕田, 开路 vt. 耕, 犁, 开路
plug	n. 塞子, 栓, 插头 vt. 插入, 塞住, 接插头 vi. 被塞住
plumb	n. 铅锤, 垂直 a. 垂直的 vt. 使垂直, 探测 vi. 成垂直
plummet	n. 测深锤, 铅坠 vi. 垂直落下
plunder	n. 抢夺, 掠夺品, 战利品 v. 掠夺, 抢劫, 抢夺
plunge	n. 钻进, 跳进, 跳水, 跳水池, 猛跌, 落下, 投入, 开始从事, 盲目投资 vi. 投入, 投身于, 跳进, 陷入, 下降 vt. 使投入, 使插入, 使陷入, 使遭受
plus	prep. 加上, 加, 外加 a. 正的, 附加的 n. 正号, 加号, 附加额, 正数, 增益 [计] 正差
pocket	n. 口袋, 钱袋, 钱, 容器 vt. 装...在口袋里, 隐藏, 抑制, 私吞, 搁置, 击...入袋 a. 袖珍的, 小型的, 压缩的, 金钱上的
point	n. 点, 小数点, 标点, 地点, 要点, 特点, 尖端, 分数, 得分, 穴位 vt. 弄尖, 强调, 指出, 加标点于, 瞄准 vi. 指, 指向, 表明
pointed	a. 尖的, 有尖顶的, 锐利的, 率直的, 显然的
pointless	a. 不尖的, 钝的, 不得要领的
poise	n. 平衡, 均衡, 姿势, 镇静, 安静, 砝码 vt. 使平衡, 使悬着, 保持...姿势 vi. 平衡, 悬着, 准备好
poke	n. 刺, 戳, 袋子 vt. 戳, 捅, 拨弄, 刺 vi. 戳, 刺, 捅, 搜索, 伸出, 行动散慢 [计] 存数
polar	a. 两极的, 极地的, 正好相反的, 极性的 n. 极线, 极面
Pole	n. 波兰人, 极点, 磁极, 电极, 杆, 竿, 相反的极端 vt. 用竿支撑 vi. 撑篙
police	n. 警察, 警察当局, 治安 vt. 维持治安, 管辖
policy	n. 政策, 方针, 策略, 保险单 [医] 凭单, 保险单
Polish	a. 波兰的 n. 波兰人, 上光剂, 光泽, 优雅 vt. 擦亮, 擦去, 使完美 vi. 擦亮, 变得光亮
politic	a. 精明的, 明智的, 策略的
political	a. 政治的, 政治上的, 政党的, 从事政治的 [法] 政治的, 政治上的, 党派政治的
pollinate	vt. 对...授粉
pollution	n. 污染, 玷污 [化] 污染
pompous	a. 爱炫耀的, 虚夸的, 盛大的
ponder	v. 沉思, 考虑
ponderous	a. 沉重的, 笨重的, 毫无趣味的, 生硬的
pop	n. 砰然声, 枪击, 含气饮料, 流行音乐, 通俗艺术 a. 流行的, 热门的, 通俗的 vt. 使发出爆裂声, 开枪打, 突然伸出 vi. 发出爆裂声, 射击, 突然出现, 瞪大 adv. 突然, 砰地 [计] 出现点, 邮局协议
popular	a. 通俗的, 流行的, 受欢迎的, 大众的, 人民的, 普及的 [经] 大众的, 通俗的, 普及的
population	n. 人口, 人口数 [化] 群体; 总体
porcelain	n. 瓷器, 瓷 a. 瓷制的
porch	n. 门廊, 走廊
pore	n. 毛孔, 小孔, 气孔 vi. 专心阅读, 细想, 钻研, 沉思, 注视 vt. 使注视得
porous	a. 多孔的, 有气孔的, 多孔性的, 能渗透的 [医] 多孔的
port	n. 港口, 埠, 舱门, 避风港, 左舷, 炮眼, 姿势, 意义 vt. 左转舵, 持(枪) vi. 左转舵 [计] 端口, 移植
portable	a. 可携带的, 可搬运的, 可移动的 [计] 可移植的
portfolio	n. 皮包, 公文包, 部长职务, 有价证券财产目录, 艺术代表作选辑 [法] 公文包, 文件夹, 阁员职务
portion	n. 部分, 一份, 命运, 嫁妆 vt. 分配, 给...嫁妆
portray	vt. 描绘, 描写, 描绘...的肖像
pose	n. 姿势, 姿态, 装模作样, 伪装 vi. 摆姿势, 装模作样, 假装 vt. 使摆好姿势, 提出, 造成
position	n. 位置, 地位, 身分, 形势, 姿势, 立场, 职位, 状态, 阵地 vt. 安置, 决定...的位置 [计] 位置
positions	n. 定位；位置（position的复数）
positive	a. 肯定的, 积极的, 有把握的 [医] 正的, 阳性的
possession	n. 拥有, 占有, 所有, 财产, 领土, 领地, 自制, 着迷 [经] 占有, 持有
post	n. 柱, 杆, 准星, 邮件, 邮政, 标竿, 职位, 岗位, 哨所, 兵营 vt. 张帖, 邮递, 公布, 登入帐, 使熟悉, 布置 vi. 快速行进 adv. 急速地 [计] 记入; 登记, 上电自检
postage	n. 邮资 [经] 邮费, 邮资
postcode	n. 邮政编码
poster	n. 海报, 招贴, 驿马
posterity	n. 子孙, 后裔 [法] 子嗣, 后代, 后裔
postgraduate	a. 大学毕业后的, 大学研究院的 n. 研究生
posthumous	a. 遗腹的, 死后的 [医] 遗腹的
postpone	vt. 延迟, 使延期, 缓办, 搁延 vi. 延缓, 延缓发作
postscript	n. 附言 [计] PostScript页面描述语言
posture	n. 姿势, 态度, 情形, 形势 vt. 作...的姿势 vi. 作姿势
potent	a. 有力的, 有说服力的, 有效的 [医] 有力的, 有性交能力的
potential	n. 潜在性, 可能性, 潜力, 潜能, 势, 位 a. 有潜力的, 可能的, 潜在的
potion	n. 饮剂, 饮料, 一次饮用量, 一服, 一剂 [医] 饮剂
pottery	n. 陶器, 陶器厂 [化] 陶器
poultry	n. 家禽
pounce	n. 猛扑, 爪 vi. 猛扑, 突袭 vt. 扑住
pounds	n. 磅, 英镑；重击（pound复数形式）
pour	n. 流出, 倾泻, 骤雨 vt. 倒, 灌, 注, 倾泻, 诉说, 倾吐 vi. 倾泻, 蜂涌而来, 下大雨
poverty	n. 贫穷, 贫困, 缺乏 [医] 贫乏, 缺乏
power	n. 力, 体力, 力量, 势力, 动力, 权力, 强国, 乘方, 强度, 幂, 功率 vt. 使...有力量, 供以动力, 激励 [计] 乘幂; DOS外部命令:能控制许多电池电源计算机上的电源管理特性
practicable	a. 可实行的, 可做的, 可用的
practical	a. 实际的, 现实的, 实用性的 [法] 事实上的, 实际上的, 接近...的
practically	adv. 几乎, 差不多, 事实上
practice	n. 实践, 练习, 实行, 惯例, 习惯, 开业 v. 实践, 实行, 练习, 实习, 业务
practitioner	n. 从业者, 开业者 [医] 行医者, 医师
pragmatic	a. 忙碌的, 爱管闲事的, 自负的, 固执己见的, 实际的, 务实的, 国事的, 国务的 [法] 闲断的, 固执己见的, 实用主义的
preach	v. 传道, 讲道, 说教, 宣讲, 鼓吹 n. 说教, 布道
precarious	a. 不稳定的, 不安的, 危险的
precaution	n. 预防, 留心, 警戒 vt. 预先警告
precautions	n. 预防措施( precaution的名词复数 ); 防备; 避孕措施
precedence	n. 优先, 居先 [计] 先后次序; 优先规定
precedent	n. 先例, 前例 a. 在先的, 在前的
preceding	a. 在前的, 前面的 [法] 在前的, 在先的, 前面的
precious	a. 宝贵的, 珍贵的, 过于精致的, 珍爱的
precipice	n. 悬崖, 绝壁, 险境
precipitate	n. 沉淀物, 凝结物, 结果 vt. 猛抛, 使陷入, 促成, 使沉淀 vi. 猛地落下 a. 突然的, 猛地落下的, 轻率的
precise	a. 精确的, 严谨的, 明确的 [机] 精密的, 正确的
precision	n. 精密, 精确, 精确度, 精度 a. 精密的, 精确的 [计] 精度
predecessor	n. 前任, 先辈, 前身 [医] 初牙, 前辈, 祖先
predictable	a. 可预言的
predisposition	n. 爱好, 素质, 癖性, 天性, 倾向, 易感受性 [医] 素因, 素质
predominant	a. 占主导地位的, 卓越的 [法] 占优势的, 支配其他的, 主要的
preface	n. 序, 绪言, 前言 vi. 作序, 写前言 vt. 给...作序, 以...开始
preference	n. 偏爱, 优先, 喜爱物 [计] 首选项
pregnant	a. 怀孕的, 充满的, 思想丰富的, 成果丰硕的 [医] 妊娠的, 有孕的
prejudice	n. 偏见, 成见, 侵害 vt. 使存偏见, 使有成见, 侵害
preliminary	n. 初步做法, 初步措施, 预试, 预选赛 a. 初步的, 开始的, 预备的
prelude	n. 前奏, 序幕, 序诗, 前奏曲 vi. 作为前奏 vt. 作为...的开头
premise	n. 前提, 房屋连地基, 上述各项 vt. 预先提出, 引出, 作为...的前提 vi. 作出前提
premium	n. 额外补贴, 奖金, 奖赏, 保险费 [医] 保险费
prepare	vt. 准备, 筹备, 使在思想上有准备, 制造, 调制 vi. 预备
preposition	n. 前置词, 介词
prerogative	n. 特权, 君权, 职权 a. 特权的, 行使特权的
prescribe	v. 规定, 指定, 嘱咐, 开处方
prescription	n. 处方, 命令, 指定 [医] 处方, 药方
presence	n. 出席, 面前, 存在, 仪态, 风度 [电] 出现
present	n. 现在, 礼品, 瞄准 a. 现在的, 出席的 vt. 介绍, 引见, 赠送, 提出, 呈现, 上演 vi. 举枪瞄准
presentation	n. 赠与, 描述, 介绍 [计] 简报
preserve	vt. 保护, 保持, 保存, 维持, 腌, 禁猎 vi. 加工食品, 禁猎 n. 加工成的食品, 禁猎地, 保护区, 防护物
pressure	n. 压, 榨, 按, 强制, 压力, 压迫, 压强 vt. 迫使, 使增压, 密封
prestige	n. 声望, 威望, 威信 [经] 商誉, 声誉
prestigious	a. 享有声望的
presumably	adv. 推测上, 大概
presumption	n. 专横, 放肆, 假定, 推测 [法] 假定, 推测, 设想
pretentious	a. 自负的, 自命不凡的, 夸耀的
pretext	n. 借口, 托词 v. 以...为借口
prevail	vi. 获胜, 流行, 盛行 [医] 流行, 盛行
prevalent	a. 普遍的, 流行的
prevention	n. 阻止, 妨碍, 预防 [医] 预防
previous	a. 早先的, 前面的, 过急的 [法] 以前的, 生前的, 前述的
prey	n. 被掠食者, 牺牲者 vi. 捕食
price	n. 价格, 代价, 价值 vt. 定...的价格
primary	n. 最主要者, 原色 a. 主要的, 初期的, 根本的, 原始的, 首要的, 基本的 [计] 初等量; 主要的; 一次的
prime	n. 最佳部分, 初期, 全盛期 a. 主要的, 最初的, 根本的 v. 加油启动, 灌注, 填装
primitive	n. 原始人, 早期艺术家 a. 原始的, 上古的 [计] 图元; 原语; 基元
principal	n. 校长, 首长, 本金, 主犯, 资本, 委托人 a. 主要的, 最重要的, 首要的
printed	a. 印刷的, 印好的, 印花样的 [电] 印刷的
printing	n. 印刷, 印刷术, 印花 [计] 打印; 印刷
prior	a. 更重要的, 较早的, 在先的 n. 小隐修院院长, 大隐修院副院长
priorities	n. 先( priority的名词复数 ); 优先; 优先权; 优先考虑的事
priority	n. 优先权, 优先 [计] 优先级
privacy	n. 隐私, 隐居, 秘密 [计] 个人保密权
private	a. 私人的, 秘密的, 私立的, 隐蔽的 n. 士兵, 隐士, 阴部 [计] 私人的
privilege	n. 特权, 特别恩典, 基本权利, 特免 vt. 给与...特权, 特免
prizes	n. 奖赏( prize的名词复数 ); 值得竞争的东西; 难能可贵的事物; 难以争取的重要事物 v. 珍视, 珍惜( prize的第三人称单数 )
probation	n. 鉴定, 查验, 证明, 试用, 察看, 缓刑 [医] 审辨, 试验, 鉴定, 试用, 见习
probe	n. 探索, 调查, 探针, 探测器 v. 用探针探测, 调查, 探索
problems	n. 问题；难题（problem的复数）
procedure	n. 程序, 过程, 手续 [计] 规程; 过程
proceed	vi. 继续进行, 进行, 开始, 发出, 起诉 [法] 所得, 收入, 收益
proceeding	n. 进行, 程序, 行动, 诉讼程序, 事项 [化] 会议论文集
process	n. 程序, 进行, 过程 vt. 加工, 使...接受处理, 对...处置, 对...起诉 a. 经加工的, 有特殊光效的 [计] 进程
processing	[计] 处理 [化] 加工
proclaim	vt. 宣布, 公告, 宣言, 表明, 赞扬 [法] 宣布, 宣告, 公布
procure	vt. 获得, 取得, 导致 vi. 拉皮条
prodigious	a. 庞大的, 惊人的, 异常的
product	n. 产品, 结果, 乘积 [化] 生产物
production	n. 制造, 生产, 产物 [医] 产生, 生成
productive	a. 能生产的, 有生产价值的, 多产的 [医] 产出性的, 产生性的
productivity	n. 生产力 [经] 生产率, 生产能力
products	n. 产品；商品（product的复数）
profane	a. 世俗的, 不敬神的, 亵渎的 vt. 亵渎, 玷污
profession	n. 职业, 表白, 声明 [化] 工种; 职业
professional	n. 专业人才 a. 专业的, 职业的
professions	n. 专业；职业；行业（profession的复数形式）
professor	n. 教授
proficiency	n. 精通, 熟练, 精练
profile	n. 侧面, 轮廓, 传略 vt. 描绘...轮廓, 写...的传略 [计] 提问档; 剖面图法; 剖面法
profit	n. 利润, 赢利, 利益 vi. 有益, 获利, 赚钱 vt. 有益于
profits	n. 收益, 红利；盈利（profit的复数）
profound	a. 极深的, 深厚的, 深刻的, 渊博的
profuse	a. 很多的, 丰富的, 浪费的, 慷慨的
program	n. 节目, 节目单, 程序, 纲要, 大纲, 计划 vt. 规划, 拟...计划 vi. 安排节目, 编程序 [计] 程序
prohibit	vt. 禁止, 阻止 [经] 禁止
project	n. 计划, 设计, 事业 vt. 计划, 设计, 投掷, 发射, 使凸出, 放映 vi. 凸出
projector	n. 计划人, 发起人, 规划人, 放映机, 映画器, 幻灯机, 幻灯, 探照灯, 发射器 [计] 投影仪
prolific	a. 有生殖力的, 多产的, 丰富的 [医] 多育的, 多产的, 繁殖的
prologue	n. 开场白, 序言, 序幕 vt. 为...作序, 加上...前言
prolong	vt. 延长, 拖延, 拖长 [化] 冷凝管
prominent	a. 卓越的, 显著的, 突出的, 凸出的
promise	n. 诺言, 约定的事情, 有指望 vt. 允诺, 约定, 预示 vi. 允诺, 有前途, 有指望
promising	a. 有希望的, 前途有望的 [经] 有希望的
promote	vt. 促进, 晋升, 创办, 推销 [经] 促进, 推广, 推销
prompt	n. 激励, 提示, 提醒物, 提词, 付款期限 a. 迅速的, 敏捷的, 立刻的, 提词员的 vt. 激励, 鼓动, 提示 adv. 准时地 [计] 提示符; DOS内部命令:设定DOS命令行的提示符
prone	a. 俯伏的, 面向下的, 有...倾向的 [医] 旋前的, 伏的, 俯的
propaganda	n. 宣传, 宣传活动 [医] 宣传
propagate	vt. 繁殖, 传播, 传送 vi. 繁殖, 蔓延
propel	vt. 推进, 驱使 [机] 推进
property	n. 财产, 所有权, 性质, 属性 [计] 属性
prophecy	n. 预言, 预言能力
proportion	n. 比例, 比率, 均衡, 部分, 面积 vt. 使成比例, 使均衡
propose	vt. 计划, 打算, 建议, 提议, 求(婚) vi. 打算, 求婚
proposition	n. 建议, 命题, 主张 vt. 向...提议, 向...提出猥亵的要求
propriety	n. 礼貌, 规矩, 适当 [计] 专有权
propulsion	n. 推进, 推进力 [医] 前冲, 慌张步态
prosecute	vt. 告发, 起诉, 彻底进行, 执行, 从事 vi. 告发, 起诉, 作检察官
prospect	n. 景色, 展望 vt. 勘探, 勘察 vi. 勘探, 有前途
prospective	a. 预期的, 将来的 [经] 预期的, 未来的
prospectus	n. 创办计划书, (内容)说明书, 内容简介 [经] (募债)说明书
protein	n. 蛋白质 a. 蛋白质的
protest	n. 抗议, 反对, 抗议书, 断言 v. 反对, 抗议, 断言
protocol	n. 草案, 礼仪, 协议 v. 拟定 [计] 协议, 协议列表实用程序
prototype	n. 原型 [计] 样机; 原型
protract	vt. 延长, 拖延, 伸出, 绘制 [法] 延迟, 拖延, 延长
protrude	vi. 伸出, 突出 vt. 使伸出, 使突出
provided	conj. 倘若, 以...为条件
provision	n. (政府提供的)钱和设备, 准备, 供应品, 规定, 条款 vt. 供给...食物及必需品
provisional	a. 暂时的, 暂定的, 临时的 [医] 临时的
provoke	vt. 激怒, 惹起, 诱导 [法] 刺激, 煽动, 激怒
proximity	n. 接近, 亲近
proxy	n. 代理, 代理人, 委托书 [经] 代理人, 代表权, 授权书
pry	n. 杠杆, 窥探, 好奇者 vi. 打听, 窥探 vt. 撬动, 撬开, 费力得到
pseudonym	n. 假名, 笔名 [法] 笔名, 假名
psychiatric	a. 精神病学的, 医精神病的 [医] 精神病学的
psychiatry	n. 精神病学, 精神病治疗 [医] 精神病学
psycholinguistics	n. 语言心理学
psychological	a. 心理学的, 精神上的, 心灵的 [法] 心理上的, 心理学的
psychology	n. 心理学, 心理状态 [医] 心理学
public	n. 公众, 民众 a. 公众的, 公共的, 公立的, 公用的
publication	n. 出版物, 出版, 公布 [经] 发布
publicity	n. 名声, 宣传, 公开场合 [经] 宣传, 广告
pull	vt. 拉, 拖, 拔, 牵, 撕开, 吸引 vi. 拉, 拖, 拔, 有吸引力 n. 拉, 拖, 拔, 拉力, 牵引力, 划船, 吸引
pulp	n. 果肉, 纸浆 vt. 使化成纸浆, 除去...果肉 vi. 变成纸浆
pump	n. 抽水机, 打气筒, 泵, 抽吸 vt. 用唧筒抽水, 打气, 盘问, 倾注, 使疲惫 vi. 抽水, 上下(或往复)运动
punctual	a. 准时的, 守时的, 点状的, 中肯的 [经] 准时的, 不误期的, 准时
puncture	n. 刺痕, 穿刺 vt. 刺穿, 刺, 揭穿 vi. 被刺穿
pungent	a. 刺激性的, 尖刻的, 苦痛的 [医] 冲味的, 刺激味的
pupil	n. 学生, 门生, 未成年人, 瞳孔 [医] 瞳孔
pure	a. 纯的, 纯净的, 纯洁的, 清白的, 完美的, 无瑕的, 抽象的 [医] 的, 纯净的
purest	a. 纯的( pure的最高级 ); 单纯的; 纯真的; 干净的
purge	n. 净化, 清除, 泻药 v. (使)净化, 清除, (使)通便 [计] 服务器文件删除实用程序
purity	n. 纯净, 纯正, 纯粹 [化] 纯度
purpose	n. 目的, 意向, 决心, 用途, 效果, 论题 vt. 意欲, 企图, 计划
purse	n. 钱包, 小钱袋, 金钱, 募捐款, 囊状物 v. 缩拢, 皱起
pursuit	n. 追踪, 追求, 追赶, 娱乐, 职业 [法] 追捕, 追求
put	vt. 放, 摆, 安置, 移动, 发射, 投掷, 写上, 表达, 使从事, 使受到, 驱使, 赋予 vi. 出发, 航行, 发芽 n. 掷, 股票出售权, 笨蛋 a. 固定不动的 [计] 发送文件
puzzle	n. 难题, 迷惑 vt. 使困惑, 使为难 vi. 迷惑, 苦思
qualification	n. 资格, 条件, 限制 [计] 限定
qualifications	n. 职位要求；任职资格；资格证书；限定性条件（qualification的复数形式）
qualify	vi. 取得资格, 有资格 vt. 使有资格, 使合格, 限定, 限制, 准予
qualitative	a. 性质的, 质的, 定性的
quality	n. 品质, 特性, 才能, 质量 a. 优质的 [计] 品质
quantitative	a. 数量的, 定量的 [医] 定量的, 数量的
quarry	n. 采石场, 方形石, 猎物, 被追求物, 来源 vt. 挖出, 努力挖掘 vi. 费力地找
quarter	n. 四分之一, 一刻钟, 季度, 地区 vt. 四等分, 肢解 vi. 驻扎, 住宿
quarterly	a. 季度的, 按季度的, 每季的 adv. 按季, 每三个月, 每季一次 n. 季刊
queer	n. 怪人, 同性恋者 a. 奇怪的, 不舒服的, 可疑的 vt. 搞糟
quench	vt. 熄灭, 结束, 使冷却, 将...淬火 vi. 熄灭, 平息
quest	n. 探索, 寻求, 调查 v. 寻找, 找, 追寻猎物
questionnaire	n. 调查表, 问卷 [经] 调查表
questions	n. 问题（question的复数）
quit	vi. 离开, 辞职, 停止 vt. 离开, 放弃, 使解除, 停止 n. 离开 [计] 结束, 退出
quiver	n. 震动, 颤抖, 箭袋 vi. 颤抖, 振动 vt. 使颤动 a. 敏捷的
quota	n. 配额, 限额 [化] 定额
rack	n. 架, 行李架, 饲草架, 搁物架, 痛苦, 折磨, 齿条, 行云团 vt. 把...放在架上, 在架上制作, 折磨, 使痛苦, 压榨, 榨取, 猛烈撕拉, 拷问 vi. 变形, 倾斜, (云)随风飘, (马)小步跑 [计] 机架
racket	n. 球拍, 喧闹, 杂乱无章 vi. 喧闹 vt. 用球拍打
radar	n. 雷达, 无线电探测器 [计] 雷达图
radiate	vt. 放射, 散发, 辐射, 传播, 广播 vi. 发光, 辐射, 流露 a. 有射线的, 辐射状的
radical	n. 激进分子, 词根, 基础, 根式, 根 a. 激进的, 根本的, 基本的, 根的
radio	n. 无线电, 收音机, 无线电报, 无线电广播, 无线电台 v. 用无线电发送
radius	n. 半径, 范围, 辐射光线 [电] 半径
raft	n. 筏, 救生筏, 大量 vi. 乘筏 vt. 筏运, 制成筏
rage	n. 愤怒, 情绪激动, 狂暴 vi. 大怒, 狂吹, 流行
ragged	a. 衣衫褴褛的, 参差不齐的, 不协调的, 粗糙的, 刺耳的
raid	n. 袭击, 突袭, 搜捕 v. 奇袭, 搜捕 [计] 廉价磁盘冗余阵列
rail	n. 横杆, 围栏, 栏杆, 铁轨, 扶手, 秧鸡 vt. 以横木围栏, 给...铺铁轨 vi. 责骂, 抱怨
railway	n. 铁路, 轨道 [经] 铁路
raincoat	n. 雨衣
rainfall	n. 降雨, 降雨量 [经] 降雨量
rainwater	n. 雨水
rally	n. 重振旗鼓, 集合, 群众集会, 跌停回升 v. 重整旗鼓, 集合, 恢复精神, 团结, 挖苦, 嘲笑
ramble	n. 漫步, 随笔 vi. 漫步, 漫谈, 漫游, 蔓延 vt. 闲逛于
rampant	a. 猖獗的, 蔓生的, 猛烈的, 跃立作扑击状的
random	n. 随意, 随机 a. 任意的, 随便的, 胡乱的, 随机的 adv. 胡乱地
range	n. 排, 行, 山脉, 范围, 行列, 射程 vt. 排列, 归类于, 使并列, 放牧 vi. 平行, 延伸, 漫游 [计] 量程; 范围; 域; 距离
rank	n. 等级, 排, 横列, 队伍, 阶级 a. 茂密丛生的, 恶臭的, 十足的, 粗俗的 vt. 排列, 归类于, 把...分等 vi. 列为, 列队 n. 秩 [计] 秩
ransom	n. 赎金, 赎身, 赎回 vt. 赎, 赎身, 赎回, 勒索赎金
rapid	a. 迅速的, 飞快的, 急促的, 陡的 n. 急流
rare	a. 稀罕的, 罕有的, 珍奇的, 稀薄的, 半熟的, 非常好的 adv. 非常
rarely	adv. 很少地, 罕有地
rat	n. 鼠, 卑鄙的人, 破坏者, 变节者 vi. 捕鼠, 变节 vt. 弄蓬松
rate	n. 比率, 率, 速度, 价格, 费用, 等级 vt. 估价, 认为, 鉴定等级, 责骂 vi. 被评价, 责骂
ratio	n. 比, 比率 [医] 比, 比率, 比例
rational	a. 理性的, 合理的 n. 有理数
ravage	n. 破坏, 蹂躏 v. 毁坏, 破坏, 掠夺
rave	n. 狂吼, 狂暴 v. 愤怒地说, 叫嚷, 咆哮
raw	n. 擦伤处, 半成品 a. 生的, 未加工的, 生疏的, 不成熟的, 阴冷的, 刺痛的, 擦掉皮的 vt. 擦伤 [计] 写后读
readers	n. 读者, 读物（reader的复数形式）
readily	adv. 迅速地, 轻易地, 乐意地
reading	n. 阅读, 知识, 读物 a. 阅读的
realm	n. 王国, 领土, 领域 [计] 领域
reap	vt. 收割, 收获, 获得 vi. 收割, 得到报应
rear	n. 后面, 背后, 后方 a. 后面的, 背面的, 后方的 vt. 养育, 培养, 饲养, 举起, 树立, 栽种 vi. 高耸, 暴跳
reason	n. 理由, 原因, 理智, 道理, 前提, 理性 vt. 说服, 推论, 辩论 vi. 推论, 劝说, 思考
reasonable	a. 合理的, 明理的, 适当的 [法] 合理的, 公道的, 正当的
reasons	n. 理由；理智；原因（reason的复数）
reassure	vt. 使...安心, 向...再保证 [法] 重新保证, 再保险, 使清除疑虑
recall	n. 回忆, 召回, 撤消 vt. 回想, 回忆, 召回, 撤消, 使恢复 [计] 检索
recede	vi. 向后退, 退却, 收回, 降低, 减弱 [医] 退缩
receipt	n. 收据, 收入, 收到 vt. 开...的收据
reception	n. 接待, 接受, 招待会 [医] 接受, 感受
receptionist	n. 接待员
recession	n. 后退, 凹处, 衰退, 归还 [医] 退缩
recipe	n. 食谱, 处方, 秘诀 [医] 取(处方头语), 处方
recipient	a. 领受的, 容易接受的, 感受性强的 n. 领受者, 容纳者, 容器
reciprocal	a. 互惠的, 相互的, 相等的, 倒数的, 彼此相反的 n. 倒数, 互相起作用的事物
recital	n. 背诵, 吟诵, 详述 [法] 叙述, 评述, 列举
recite	v. 背诵, 朗读, 叙述
reckless	a. 不介意的, 大意的, 鲁莽的, 不顾后果的 [法] 不注意的, 粗心大意的, 鲁莽的
reckon	vt. 计算, 总计, 估计, 认为, 猜想 vi. 数, 计算, 估计, 依赖, 料想
reclaim	vt. 开垦, 改造, 感化, 纠正, 回收 vi. 喊叫, 抗议
recline	vt. 使斜靠 vi. 靠, 斜倚, 依赖
recommendation	n. 推荐, 介绍, 推荐信, 劝告 [经] 建议书
reconcile	vt. 使和解, 调停, 使和谐, 使一致, 使听从 [经] 对帐, 使一致
record	n. 记录, 履历, 档案, 审判记录, 最高纪录, 唱片 vt. 记录, 记载, 标明, 将...录音 vi. 记录, 录音, 可被录音 a. 创纪录的 [计] 录制, 记录
recorder	n. 记录员, 录音机 n. 记录器 [计] 宏录制器, 记录器
recording	a. 记录的, 记录用的 n. 录音
records	n. 记录, 录音；唱片, 档案（record的复数形式）
recover	vt. 重新获得, 恢复, 复原, 拯救 vi. 痊愈, 复原, 胜诉 [计] 恢复
recreation	n. 娱乐, 消遣, 休息, 再创造 [医] 娱乐, 休养
recruit	n. 新兵, 新手, 新会员, 补给品 vt. 恢复, 补充, 充实, 征募 vi. 征募新兵, 复原, 得到补充
rectangle	n. 长方形, 矩形 [化] 矩形
rectify	vt. 订正, 矫正, 改正, 调正, 校正, 精馏, 整流 [化] 精馏
recycle	vt. 使再循环, 重新利用, 再制 n. 再循环
recycled	v. 回收利用( recycle的过去式和过去分词 ); 再利用; 再次应用; 重新使用（概念、方法、玩笑等）
recycling	[电] 再循环
redeem	vt. 赎回, 挽回, 恢复, 偿还, 补偿 [经] 履行(契约), 买回, 赎回
redundant	a. 多余的, 过多的, 冗长的 [医] 过多的, 多余的
reel	n. 卷轴, 一卷, 纺车, 旋转, 蹒跚 vt. 卷...于轴上, 绕, 使旋转 vi. 蹒跚地走, 旋转, 眩晕, 摇晃, 退缩 [计] 卷; 盘
referee	n. 仲裁人, 调解人, 裁判员 v. 仲裁, 裁判
referees	n. 裁判员( referee的名词复数 ); 证明人; 公断人; （专业性强的文章的）审阅人
reference	n. 参考, 索引, 参照 vt. 给...加上参考资料 vt. 引用 vi. 引用 [计] 引用
referendum	n. （就重大政治或社会问题进行的）全民公决，全民投票
refine	vt. 精炼, 净化, 使优雅, 使精炼 vi. 被精炼, 被净化
reflectance	n. 反射比 [电] 反射本领
reform	n. 改革, 改正, 改造 vt. 改革, 改过, 革新, 重整 vi. 革新, 改过
refrain	n. 重复的话, 叠句, 副歌 vi. 节制, 避免, 克制
refreshing	a. 使清爽的, 有精神的, 爽快的
refreshment	n. 点心, 起提神作用的事物, 精神爽快
refreshments	n. 茶点；点心；小吃
refugee	n. 难民, 流亡者 [法] 避难者, 流亡者, 难民
refund	n. 偿还 vt. 付还, 偿还借款 vi. 归还, 偿还
refusal	n. 拒绝, 推却, 优先决定权 [法] 拒绝, 谢绝, 取舍权
regarding	prep. 关于
regardless	a. 不管, 不注意, 不顾
regeneration	n. 再生, 重建 [化] 再生作用
regime	n. 政权, 当权期间, 政体, 社会制度, 体制, 情态 [医] 制度, 生活制度
region	n. 区域, 地带, 地区, 领域, 范围, 区 [计] 区, 区域
regional	a. 地方的, 地域性的 [医] 区的, 部位的
register	n. 寄存器, 记录, 登记簿, 注册 vt. 记录, 注册, 提示, 表达, 把...挂号 vi. 登记, 注册, 挂号 [计] 寄存器
registrar	n. 记录者, 登记者, 登记官员 [医] 登记员, 挂号员, 专科住院医师
registration	n. 登记, 挂号, 注册 [计] 登记; 定位; 对齐; 记录
regular	a. 规则的, 常例的, 有秩序的, 整齐的, 等边的, 定期的, 经常的, 合格的, 常备军的 n. 正规军, 正式队员 adv. 经常地 n. 正常体 [计] 正常体
regularly	adv. 有规则地, 一丝不苟地, 正式地
regulate	vt. 管理, 控制, 调节, 调整, 校准 [经] 控制, 管理
regulation	n. 规则, 管理, 调整 [计] 调整; 规章; 规则; 调节
regulations	n. 章则；条例；规程（regulation的复数）
rehabilitate	vt. 恢复原状, 修复, 使康复 [法] 恢复, 使恢复心理健康, 修复
rehearsal	n. 预演, 排演, 练习, 叙述, 复述 [法] 详述, 列举事实, 复述
reign	v. 为王，为君；当政；统治 n. 为王，为君；当政；统治
reimburse	vt. 付还, 偿还, 赔偿 [经] 偿付, 赔还, 付还; 偿还
reinforce	vt. 加强, 增援, 补充 vi. 求援, 得到增援 n. 加固材料
reinforced	a. 加强的；加固的；加筋的
rejoice	vt. 使欢喜 vi. 欣喜, 高兴, 庆祝
relapse	n. 回复, 故态复萌, 复发 vi. 故态复萌, 再陷邪道, 再度堕落
related	a. 讲述的, 叙述的；有关系的, 有关联的
relations	n. 交往, 关系, 事务
relationship	n. 关系, 关联 [医] 关系
relaxation	n. 松弛, 放松, 减轻, 缓和, 休息, 休养 [化] 松弛; 驰豫
relay	n. 驿马, 替班, 中继, 接力 vt. 分程传递, 转播, 使接替 vi. 接力传送, 转播
release	n. 释放, 发泄, 豁免, 发行, 释放证书 vt. 释放, 解除, 放松, 豁免, 免除, 发布, 放弃, 让与 n. 发布 [计] 版本, 发布
relentless	a. 无情的, 冷酷的, 残酷的
relevant	a. 有关联的, 有关系的, 适当的, 相应的 [法] 有关的, 相关的
reliable	a. 可靠的, 可信赖的 [法] 可靠的, 可信赖的, 确实的
relief	n. 减轻, 解除, 救济, 安慰, 调剂, 浮雕, 换班, (地势的)起伏 [医] 缓减, 减轻, 浮雕(绘画中)
religion	n. 宗教, 信仰 [法] 宗教, 宗教信仰, 信仰
relinquish	vt. 放弃, 撤回, 停止, 松开, 让与 [法] 让与, 把...交给, 放弃
reluctant	a. 不情愿的, 勉强的 [法] 不愿的, 勉强的, 难以处理的
rely	vi. 信赖, 依赖, 信任
remark	n. 评论, 注意 vt. 评论, 注意 vi. 评论, 谈论 [计] 注释
remarkable	a. 不平常的, 值得注意的, 显著的
remedy	n. 药物, 治疗法, 治疗, 补救, 赔偿 vt. 治疗, 补救, 矫正, 改善, 修补, 修缮
remind	vt. 提醒, 使想起
remittance	n. 汇款 [经] 汇款, 寄款, 支付(金额)
remnant	n. 剩余, 零料, 遗迹 a. 剩余的, 残余的
remorse	n. 懊悔, 良心不安, 自责, 同情 [法] 悔恨, 自责, 懊悔
removal	n. 移动, 移居, 迁移, 排除, 切除 [医] 切除, 除去
renaissance	n. 复活, 复兴, 文艺复兴 a. 文艺复兴的
render	vt. 回报, 给于, 付给, 汇报, 提出, 舍弃, 反映, 表示, 表演, 致使, 执行, 实施 vi. 给予补偿 n. 交纳, 打底
rendezvous	n. 约会, 约会地点 v. 集合, 集结, 在约定场所会面 [计] 会合
renewal	n. 更新, 革新, 复兴, 恢复, 修补, 补充, 继续, 重订, 重申, 续借 [经] 更新, 换新, 重申
renovation	n. 革新, 刷新, 修理 [化] 改建
renowned	a. 有名的, 有声誉的
rent	n. 租金, 房租, 出租物, 裂缝, 破裂处, 分裂 vt. 租用, 租出 vi. 出租 a. 分裂的, 破裂的 rend的过去式和过去分词
rental	n. 租费, 租金收入 a. 租赁的, 收取租金的
repair	n. 修理, 补救, 修复 vt. 修理, 修补, 补救, 恢复, 补偿 vi. 修理, 修补, 补救, 恢复, 去, 常去, 集合
repatriate	vt. 把...遣返 vi. 回国 n. 被遣返回国者
repel	vt. 逐退, 抵制, 使厌恶, 抗御 vi. 使厌恶, 相互排斥
repent	vi. 后悔, 懊悔, 忏悔 vt. 后悔 a. 匍匐生根的
repertoire	n. 全部剧目, 全部技能, 全部节目, 全部作品
repetition	n. 重复, 背诵, 循环, 复制品, 副本 [机] 重复, 反复
replacement	n. 归还, 更换, 代替者 [医] 复位, 置换
report	n. 报告, 报道, 传说, 案情报告, 爆炸声, 成绩单 vt. 报告, 汇报, 转述, 报道, 揭发, 使报到 vi. 报告, 写报道, 报到 [计] 报告
reports	n. 报表；专题；报告（report的复数）
represent	vt. 表现, 表示, 描绘, 讲述, 代表, 象征, 回忆, 再赠送, 再上演 vi. 提出异议
representative	n. 代表, 众议员, 典型 a. 描写的, 表现的, 代理的, 代表的, 代议制的, 典型的
reproach	n. 责备, 耻辱 vt. 责备, 申斥, 使丢脸
reptile	n. 爬行动物, 爬虫, 卑鄙的人 a. 爬行的, 爬虫类的, 卑鄙的
reputation	n. 名誉, 名声, 声望 [法] 名声, 名誉, 公认证据
request	n. 请求, 需要, 申请书 vt. 请求, 要求, 邀请 [计] 请求
requirement	n. 需求, 必要条件, 要求 [化] 要求; 合同要求
rescue	n. 援救, 解救, 营救 vt. 援救, 救出, 营救
research	n. 研究, 调查, 考察 vi. 研究, 调查
resemblance	n. 相似处, 类似, 肖像
resemble	vt. 相似, 类似
resent	vt. 愤恨, 憎恶, 怨恨
reservation	n. 保留, 预定, 保留品, 保留地 [经] 预定, 预约, 权益保留
reserve	n. 储备品, 贮量, 后备军, 自然保护区, 保留, 拘谨, 节制, 储备金 vt. 保留, 保存, 预订, 延期, 推迟
reservoir	n. 贮水池, 贮藏处, 贮备, 水库 vt. 储藏
residence	n. 住宅, 居留, 驻扎, 居住期间 [医] 住房
residents	n. 居民；房客；住院医生（resident的复数）
resign	vt. 辞职, 放弃, 使顺从 vi. 辞职, 屈从
resignation	n. 辞职, 辞呈, 听从 [经] 辞职
resilience	n. 弹回, 有弹力, 恢复力 [化] 回弹; 弹性; 弹回性; 回能; 弹能
resistance	n. 抵抗力, 反抗, 耐力, 阻力, 电阻 [化] 抵抗; 抗性; 阻力; 抗药性; 电阻
resistant	n. 抵抗者, 反抗者 a. 抵抗的, 反抗的, 耐...的
resolution	n. 解析, 决心, 坚定, 决定, 决议, 消除, 解答, 分解 n. 图形分辨率 [计] 图形分辨率
resolve	vi. 决定, 分解, 决心 vt. 使分解, 解析, 解决, 消除, 决心 n. 决定之事, 决心, 坚决
resonant	a. 共鸣的, 反响的, 洪亮的, 共振的 [医] 反响的, 叩响的, 共鸣的, 共振的
resort	n. 度假胜地, 手段, 凭借, 常去之地 vi. 诉诸, 常去
resource	n. 资源, 财力, 办法, 策略, 急智, 消遣 [计] 资源
resources	n. 资源；物力（resource的复数）
respiration	n. 呼吸, 一口气, 呼吸作用 [化] 呼吸
respondents	n. <律>（尤指离婚案的）被告( respondent的名词复数 ); 回答问题的人, （尤指）调查对象
response	n. 反应, 回答, 响应 [计] 应答
responsibility	n. 责任, 职责, 负担, 可靠性 [化] 职责
responsive	a. 回答的, 应答的, 易感应的
restaurant	n. 餐馆, 饭店
restaurants	n. 饭店( restaurant的名词复数 ); 餐馆; 饭馆; 菜馆
restless	a. 不安静的, 慌张的, 休息不充分的 [医] 不安静的, 不宁的
restore	vt. 回复, 恢复, 归还, 修补, 修复 vt. 还原 vi. 还原 [计] 还原; DOS外部命令:从备份盘中取回文件
restrain	vt. 抑制, 阻止, 束缚 [法] 抑制, 遏制, 制止
result	n. 结果, 成绩, 答案 vi. 产生, 结果, 致使 [计] 结果
results	n. 结果；成绩（result的复数）
resume	vt. 重新开始, 取回, 恢复 vi. 再开始 n. 摘要, 个人简历 [计] 继续执行
retail	n. 零售 a. 零售的 vt. 零售, 详述, 传播 vi. 零售
retails	v. 零售；转述（retail的第三人称单数）
retain	vt. 保持, 保有, 留住, 记得, 付定金聘请 [经] 保留, 留存
reticent	a. 无言的, 沉默的, 不情愿的 [法] 言不尽意的, 沈默寡言的, 有保留的
retirement	n. 退休, 隐居, 撤退 [经] 退休, 退股, (固定资产)报废
retort	n. 反驳, 顶嘴, 蒸馏器, 曲颈甑 vi. 反驳, 回嘴, 反击 vt. 反击, 反驳, 蒸馏
retreat	n. 休息寓所, 撤退, 隐居, 退避 vi. 撤退, 隐退, 向后倾 vt. 退(棋)
retrieve	vt. 取回, 挽回, 弥补, 恢复, 补偿, 回忆, 检索 vi. 找回猎物 n. 取回, 恢复, 救险球 [计] 检索
retrospect	n. 回顾, 追忆, 回溯 v. 回顾, 追忆
return	n. 回来, 返回, 来回票, 归还, 报答, 利润率, 报告书 a. 返回的, 回程的, 报答的, 反向的, 重现的, 复原的 vi. 返回, 归还, 回来 vt. 归还, 还, 回报, 产生, 反射, 报告, 申报, 退回 [计] 返回
revelation	n. 揭露, 泄露, 发觉, 默示, 启示
revenge	n. 报仇, 复仇, 报复 vt. 报仇, 报复
revenue	n. 收入, 岁入, 税收, 税务局 [经] 岁入, 税收, 税务局
reverent	a. 尊敬的, 虔诚的
reverse	n. 相反, 背面, 倒退, 挫折, 失败 a. 反面的, 相反的, 反向的, 颠倒的 vt. 使颠倒, 使逆转, 使倒退, 使反向 vi. 倒退, 反向, 倒转, 反转 [计] 反转
review	n. 检讨, 复习, 回顾, 检阅, 评论 vt. 温习, 检讨, 评论, 再检察, 复审 vi. 复习功课, 写评论
revise	n. 校订, 修正, 改样 vt. 校订, 修正, 校正
revision	n. 校订, 修正, 修订本, 修订版 [计] 修订版
revive	vt. 使苏醒, 使复兴, 使振奋, 回想起, 重播 vi. 苏醒, 复活, 复兴, 恢复精神
revolt	n. 叛乱, 反抗, 反感 vi. 叛乱, 反抗, 起义, 厌恶, 反感 vt. 使反感, 使恶心
revolve	v. (使)旋转, 反复考虑, 循环出现
reward	n. 报酬, 酬谢, 赏金 vt. 奖赏, 酬谢, 给...应有报应
rhetoric	n. 修辞, 修辞学, 雄辩(术)
rhythm	n. 旋律, 节奏, 韵律, 匀称, 张弛节律 [医] 节律
ribbon	n. 缎带, 色带, 带状物 vt. 用丝带装饰, 把...撕成条状 vi. 形成带状 [计] 带状条, 格式栏
rice	n. 米, 米饭, 稻 vt. 将...压成米粒状
riders	n. 骑（马、自行车等）的人( rider的名词复数 ); 乘客; 附文; 附加条款
ridge	n. 脊, 山脊, 山脉 [医] 嵴, 脊, 棱线
ridiculous	a. 荒谬的, 可笑的
rig	n. 装备, 帆装 vt. 装配, 装扮, 给船装帆, 垄断, 操纵
righteous	a. 公正的, 正义的, 正直的 [法] 正直的, 正当的, 正义的
rigid	a. 坚硬的, 刚性的, 严格的, 精密的, 刻板的
rigorous	a. 严厉的, 严酷的, 严格的, 苛刻的, 严密的, 精确的
rim	n. 边, 轮缘, 框 vt. 镶边, 为...装边 vi. 形成边缘
riot	n. 暴动, 喧闹, 放纵 vi. 发动, 暴动, 纵情, 放荡 vt. 浪费, 挥霍
rip	n. 裂痕, 破绽, 拉裂, 浪子, 巨浪 vi. 被拉开, 裂开, 猛冲 vt. 撕, 扯, 劈
ripple	n. 涟波, 涟漪, 波纹, 粗钢梳 vt. 使起涟漪 vi. 起微波, 起潺潺声
rising	n. 上升, 造反, 叛乱 a. 上升的, 高涨的, 新兴的
risks	n. 风险, 危险（risk复数）
ritual	n. 仪式, 典礼, 宗教仪式 a. 仪式的, 依仪式进行的
rival	n. 对手, 竞争者 a. 竞争的
rivers	n. 里弗斯（人名）；河流州（尼日利亚州名）；河水钻
rivet	n. 铆钉 vt. 用铆钉固定, 敲进去, 注目, 吸引住
road	n. 路, 道路, 公路, 途径, 方法 [法] 公路, 道路, 行车道
roam	v. 漫游, 闲逛, 徜徉 n. 漫步, 漫游
roar	n. 吼, 咆哮, 轰鸣 vi. 吼, 大声说出, 叫喊, 喧闹 vt. 呼喊, 使轰鸣
roast	n. 烤肉, 烘烤, 嘲笑 a. 烘烤的, 烤过的 vt. 烤, 炙, 烘焙, 嘲笑 vi. 烤, 炙, 烘焙
robber	n. 强盗, 盗贼
robots	n. 机器人（robot的复数形式）
robust	a. 健康的, 强健的, 要用力气的, 坚定的, 粗野的 [计] 健壮性
rock	n. 岩石, 岩礁, 石头, 基石, 暗礁, 摇动, 摇滚乐 vt. 摇摆, 摇动, 使摇晃, 使动摇 vi. 摇, 摇动
rocks	n. 岩石, 岩礁；岩石礁石（rock复数形式）
role	n. 角色, 职责, 任务 [医] 作用, 功用
roll	n. 卷, 滚动, 名单, 案卷, 压路机 vi. 滚, 滚动, 飘流, 起伏, 卷, 绕 vt. 使滚动, 卷, 绕
room	n. 房间, 空位, 场所 vi. 住宿, 居住 vt. 留宿
roommate	n. 住在同室的人
rot	n. 腐烂, 腐蚀, 败坏 vi. 腐烂, 烂, 堕落, 憔悴 vt. 使腐烂, 使腐朽, 使堕落
rotate	a. 辐状的 vt. 使旋转, 使转动, 使轮流 vi. 旋转, 循环 [计] 旋转
rough	n. 粗糙的东西, 毛坯, 未加工品, 梗概, 草图, 暴徒, 艰难 a. 粗糙的, 粗暴的, 蓬乱的, 草率的, 大致的, 简陋的, 暴风雨的, 艰难的 vt. 使粗糙, 使不平, 使蓬乱, 粗制, 草拟, 粗暴对待, 对...动粗 vi. 变粗糙 adv. 粗糙地, 粗暴地
rouse	n. 觉醒, 奋起, 干杯 vt. 唤醒, 鼓舞, 激动, 使振奋, 惊起 vi. 醒来, 奋起
route	n. 路径, 途径, 路线 vt. 确定路线, 按规定路线发送 [计] 传递, 路由设定程序
routine	n. 常规, 日常工作, 惯例, 例行公事 a. 日常的, 常规的 [计] 例程
rows	n. 返回引用中的行数；行（row的复数形式）
royal	n. 王室, 皇族 a. 王室的, 皇家的, 盛大的, 庄严的
rub	n. 摩擦, 困难, 障碍, 磨损处 vt. 擦, 搓, 摩擦, 惹怒 vi. 摩擦, 擦破
rubber	n. 橡皮, 橡胶, 做摩擦动作的人, 按摩师, 决胜盘 vt. 用橡胶制造, 涂橡胶于
rubbish	n. 废物, 垃圾, 胡说
ruffle	n. 皱褶, 波纹, 生气, 混乱 vt. 弄皱, 触怒, 洗(牌), 连续轻擂(鼓) vi. 起皱, 发脾气, 连续轻擂
ruinous	a. 破坏性的, 招致毁灭的
rule	n. 规则, 统治, 控制, 支配, 规律, 标准, 章程, 破折号, 铅线 vt. 规定, 统治, 管理, 控制, 支配, 裁决 vi. 统治, 管辖, 裁定 [计] 规则, 水线
rules	n. 规则；条例（rule的复数形式）
rumour	n. 谣言, 传闻 vt. 谣传
rupture	n. 破裂, 断裂, 裂开, 决裂, 不和 v. (使)破裂
rural	a. 乡下的, 田园的, 乡村风味的 [法] 农村的, 乡村的, 有关农业的
Russia	n. 俄国, 俄罗斯 [法] 俄罗斯, 苏联
rust	n. 锈, 生锈, 衰退 vi. 生锈, 衰退 vt. 使生锈, 腐蚀
ruthless	a. 无情的, 残忍的, 毫不留情的, 彻底的 [法] 无情的, 残忍的
sabotage	n. 怠工, 破坏活动, 破坏 vi. 从事破坏活动 vt. 妨害, 破坏
sack	n. 麻布袋, 洗劫 vt. 把...装入袋, 洗劫
sacred	a. 神圣的, 献给上帝的, 庄严的, 祭祀的 [法] 神圣的, 不可侵犯的
sacrifice	n. 牺牲, 供奉, 祭品 vt. 牺牲, 祭祀, 贱卖 vi. 献祭
saddle	n. 鞍, 马鞍, 车座, 鞍状物 vt. 装以马鞍, 使负担 vi. 跨上马鞍
safari	n. 旅行, 旅行队, 科学考察
safe	n. 保险箱, 冷藏室 a. 安全的, 可靠的, 平安的, 稳健的, 有把握的
safeguard	n. 保卫, 保护措施, 防护设施 vt. 保卫, 保护
safety	n. 安全, 保险, 平安, 保安设备 vt. 保护, 防护
sailing	n. 航行, 航海术, 启航 a. 航行的
sake	n. 目的, 缘故, 理由
salad	n. 色拉
salary	n. 薪水 vt. 给...加薪
sale	n. 出售, 卖, 拍卖, 销售额, 廉价出售 [经] 卖, 出售; 销售(货)
sales	a. 销售的 [计] 销售
saline	a. 盐的, 苦涩的, 由碱金属(或含镁之盐类)组成的 n. 盐湖, 盐田, 碱盐泻药, 生理盐水
salute	vi. 行礼, 致意, 问候, 放礼炮 vt. 向...致意, 迎接, 赞扬 n. 招呼, 敬礼, 礼炮
salvage	n. 海上救助, 抢救, 打捞, 抢救出来的财物 vt. 海上救助, 抢救, 打捞, 营救 [计] 文件恢复程序
sample	n. 样品, 范例, 样本 vt. 抽样, 尝试 [计] 示例, 字样
sanction	n. 核准, 制裁, 处罚, 约束力 vt. 制定制裁规则, 认可, 核准, 同意
sandwich	n. 三明治, 夹心面包, 夹层板 vt. 插入, 夹入, 把...制成三明治
sanitary	a. 卫生的 n. 公共厕所
sanity	n. 神智健全, 头脑清楚, 通情达理 [医] 精神健全
sarcasm	n. 挖苦, 讽刺, 讽刺话, 讽刺性
satellite	n. 人造卫星 [医] 伴行静脉, 陪静脉, 陪病部, 随体, 卫星
satisfaction	n. 满足, 满意, 快事, 赔偿, 赎罪, 报仇的机会 [经] 偿还, 赎回
saturate	vt. 使渗透, 浸透, 使充满, 使饱和 a. 浸透的, 饱和度高的, 深颜色的 n. 饱和化合物, 饱和脂肪酸
Saturday	n. 星期六
sauce	n. 酱油, 调味汁, 酱 vt. 给...调味, 使增加趣味
savage	a. 未开化的, 野蛮的, 无礼的, 残酷的, 原始的, 粗鲁的, 未开发的 vt. 用暴力对付, 凶猛攻击 n. 原始人, 粗鲁人
saving	n. 存款, 挽救, 节约 a. 搭救的, 节约的, 保留的, 补偿的 prep. 除...之外
savings	n. 储蓄, 存款 [经] 储金, 储蓄
say	vt. 说, 讲, 念, 说明, 指明 vi. 说, 讲 n. 意见, 发言权
scale	n. 刻度, 衡量, 比例, 比例尺, 数值范围, 等级, 规模, 天平, 秤, 鳞, 积垢 vt. 依比例决定, 攀登, 测量, 绘制, 刮鳞, 使生垢, 过秤 vi. 剥落, 生水垢, 重量为, 攀登, 衡量 [计] 刻度
scalpel	n. 解剖刀 vt. 用解剖刀切开
scan	n. 审视, 浏览, 扫描, 细查 vt. 细看, 浏览, 扫描, 详细调查, 标出格律 vi. 押韵, 扫描 [计] 网络软件目录, 编码与分析系统
scandal	n. 丑闻, 中伤, 耻辱, 反感, 流言蜚语 [法] 丑事, 丑闻, 干丑事的人
scant	a. 不充分的, 不足的 vt. 减少, 吝啬, 限制, 藐视, 忽略
scapegoat	n. 替罪羔羊, 替人顶罪者, 替身 [法] 替罪羊, 代人受过者
scar	n. 疤痕, 伤痕, 悬崖 vi. 结疤, 愈合, 痊愈 vt. 使有伤痕
scarce	a. 难得的, 稀罕的, 缺乏的
scarcely	adv. 简直不, 一定不, 仅仅
scatter	n. 消散, 分散, 散播, 散射, 散布, 酒馆 vi. 散布, 散播, 消散 vt. 使消散, 使分散, 撒, 散布, 散播, 散射 [计] 散点图
scenery	n. 风景, 景色, 舞台布景
scent	n. 气味, 香味, 香水, 踪迹, 痕迹, 线索, 嗅觉 vt. 闻出, 嗅, 发觉, 使充满气味 vi. 嗅猎, 发出气味
sceptical	a. 怀疑论的, 怀疑的
schedule	n. 时间表, 一览表, 计划表, 议事日程 vt. 预定, 编制目录, 制...表, 安排
scheme	n. 方案, 计划, 组合, 系统, 图解, 诡计, 阴谋 v. 计划, 设计, 图谋, 策划 [计] Scheme 程序设计语言
scholarship	n. 学问, 学术成就, 奖学金
school	n. 学校, 鱼群, 门派, 学派 vt. 教育, 训练, 培养 vi. 成群地游
science	n. 科学, 学科, 学问, 自然科学 [医] 科学
scientific	a. 科学的, 系统的, 符合科学规律的 [计] 科学记数法
scientists	n. 科学家( scientist的名词复数 )
scissors	pl. 剪刀 [医] 剪
scold	n. 好骂街的人, 责骂 v. 责骂
scoop	n. 铲子, 勺子, 穴, 口, 独家新闻 vt. 汲取, 舀取, 挖空, 抢先报道
scorch	n. 烧焦, 枯萎 v. 烧焦, 拷焦, (使)枯萎, 讽刺
score	n. 得分, 抓痕, 二十个, 刻痕, 帐目, 乐谱, 起跑线, 终点线, 大量 vt. 刻划, 划线, 获得, 评价, 把...记下 vi. 刻痕, 记分, 得分 [计] 得分
scorn	n. 轻蔑, 藐视, 嘲笑, 被嘲弄的人 vt. 轻蔑, 不屑做
Scotland	n. 苏格兰
scotsman	n. 苏格兰人
scout	n. 守候, 侦察, 搜索, 侦察员, 侦察机 vi. 守候, 侦察, 巡视, 嘲笑 vt. 侦察, 跟踪, 发现, 监视, 嘲弄
scrap	n. 碎片, 残余物, 些微, 片断, 铁屑, 吵架 vt. 扔弃, 敲碎, 拆毁 vi. 互相殴打 a. 零碎拼凑成的, 废弃的
scrape	n. 刮, 擦, 挖, 擦痕, 刮擦声, 困境 vi. 刮掉, 擦掉, 刮出刺耳声 vt. 刮, 擦, 擦伤, 挖成, 积蓄
scratch	n. 抓痕, 搔, 抓, 擦伤, 刮擦声, 乱写, 零分, 起跑线 vt. 搔, 抓, 挖出, 擦, 刮, 乱涂, 勾抹掉 vi. 搔, 抓, 发刮擦声, 勉强糊口 a. 碰巧的, 凑合的, 打草稿用的 [计] 擦除
screw	n. 螺旋, 螺杆, 螺钉, 螺旋桨, 吝啬鬼 vt. 调节, 扭紧, 旋, 拧, 加强, 压榨, 勒索 vi. 转动, 旋, 拧
script	n. 手迹, 手稿, 正本, 手写体 vt. 改编为演出本 [计] 手写体, 小型程序
scroll	n. 卷轴, 画卷, 名册, 条幅, 滚动 v. (使)成卷形 [计] 滚动
scrupulous	a. 小心谨慎的, 细心的
scrutiny	n. 细看, 仔细检查, 监视, 选票检查 [经] 复查, 评核, 仔细检查
sculpture	n. 雕刻, 雕塑 vt. 雕刻, 雕塑 vi. 当雕刻师
scum	n. 浮渣, 糟粕, 浮藻, 熔渣, 不起好作用的人 vt. 撇去(浮沫) vi. 产生泡沫
seafood	n. 海味, 海鲜, 鱼类
seal	n. 印章, 封条, 海豹, 海豹皮, 火漆, 封蜡, 玺, 保证, 批准, 象征, 标志 vt. 封闭, 盖印, 盖章 vi. 猎海豹
seam	n. 缝合线, 衔接口, 接缝, 线缝, 伤疤 vt. 缝合, 接合, 焊合, 使留下伤痕 vi. 裂开, 发生裂痕
season	n. 季节, 时节, 当令期, 时期 vt. 给...调味, 使成熟, 使老练, 缓和 vi. 变干燥
seasoned	a. 经验丰富的, 老练的
seat	n. 座, 座位, 位子, 席位, 所在地 vt. 使坐下, 使就座, 为...设座于, 使就职 vi. 安装在底座上
seats	n. 座椅, 座位（seat的复数形式）
seclude	vt. 使隔离, 使孤立, 隔开
second	n. 秒, 瞬间, 第二名, 支持者, 助手 a. 第二的, 其次的, 次要的, 附加的, 辅助的 num. 第二 vt. 当...助手, 支持
second-hand	a. 用过的, 旧货的, 旧的, 间接的, 传来的, 第二手的 [机] 半新的, 旧货
secondary	a. 中级的, 中等的, 次要的, 第二的, 从属的, 辅助的 [化] 仲(指CH-3...CH(CH-3)-型支链烃基或指二元胺及R-2CHOH型的醇); 第二
secretary	n. 秘书, 书记, 大臣 [经] 秘书
secretion	n. 分泌, 分泌物, 分泌液, 隐蔽 [医] 分泌; 分泌物
section	n. 区段, 部分, 区域, 节, 截面, 处, 科, 区, 扇区 vt. 把...分段, 把...切片 vi. 被切成片 [计] 扇区
sectional	a. 部分的, 部门的, 节的, 截面的 n. 组合式家具
sector	n. 扇形, 部门, 部分, 函数尺, 象限仪, 段, 区段 vt. 把...分成扇形 [计] 扇面; 扇区; 段; 区段
secular	n. 修道院外的教士 a. 世俗的, 现世的, 长期的
sediment	n. 沉淀物, 沉积 [化] 沉降物; 沉积物
seemingly	adv. 看来似乎, 表面上看来
seep	vi. 渗出, 渗流, 漏 n. 小泉, 水陆两用吉普车
segment	n. 片段, 部分, 分节, 段 v. 分割, 分裂 [计] 段
segregate	a. 分离的, 被隔离的 vi. 分离, 隔离, 分凝 vt. 使分离, 使隔离
seismic	a. 地震的
selection	n. 选择, 选文, 精选品 [医] 选择, 淘汰
self-defense	n. 自卫, 自卫术, 自卫权 [法] 自卫, 正当防卫
self-discipline	n. 自我训练, 自我修养, 自律 [法] 自律, 自我约束, 自我修养
self-sufficient	a. 自给自足的, 极为自负的
semblance	n. 外表, 伪装, 假象, 少量
semester	n. 学期
seminar	n. 研究班, 专题讨论会 [经] 讨论会, 专家讨论会
senior	n. 年长者, 资深者, 毕业班学生 a. 年长的, 高级的, 资深的
sense	n. 感应, 感觉, 感官, 意识, 观念, 情理, 知觉, 理智 vt. 感觉, 觉察, 检测 [计] 阅读; 检测
sensible	a. 有感觉的, 敏感的, 明智的 [医] 可感觉的
sensitive	a. 敏感的, 易感的, 灵敏的, 感光的 [机] 敏感的, 灵敏的, 感度高的
sentences	n. [律]判决, 宣判; 句子（ sentence的名词复数 ） v. 宣判, 判决（ sentence的第三人称单数 ）
sentiment	n. 感情, 感伤, 情操, 情绪, 感想, 意见 [医] 情感, 情操
September	n. 九月
septic	a. 腐败的, 脓毒性的 n. 引起腐败的物质
sequence	n. 序列, 续发事件, 顺序, 连续 vt. 按顺序排好 [计] 顺序
serial	n. 分期连载作品, 连载小说 a. 连续的, 一连串的, 连载的, 分期偿还的 [计] 连续的; 串行的
series	n. 串联, 序列, 连续, 系列, 丛书, 套, 级数, 组 [计] 系列
serious	a. 严肃的, 认真的, 重要的, 严重的 [电] 严重的
service	n. 服务, 贡献, 雇佣, 公职, 服役, 功劳, 仪式, 送达, 行政部门 vt. 保养, 维修 a. 武装部队的, 服务性的, 仆人的, 耐用的 [计] 服务, 业务
session	n. 期间, 开庭期, 会议, 学期 [计] 会话, 对话, 会晤, 通用任务程序
set	n. 日落, 同伙, 组合, 集合, 装置 vt. 放, 安置, 放置, 设定, 使凝结, 点燃, 确定, 点缀, 使就位, 树立, 分配, 调整 vi. 日落, 凝固, 定型, 搁住, 结果, 适合 a. 决心的, 规定的, 故意的, 持久的, 固定的, 老套的, 准备好的 [计] 设置; DOS内部命令:改变或显示分配给环境变量的值
setback	n. 挫折, 退步, 逆流
setting	n. 环境, 背景, 布景, 镶嵌, 调整, 沉落, 一副餐具 [计] 设置
settle	n. 有背长椅 vt. 决定, 整理, 安放, 使定居, 使平静, 支付, 安排, 解决, 结算 vi. 停留, 下陷, 沉淀, 澄清, 安下心来, 结清, 定居, 安家
settlement	n. 安顿, 解决, 处理, 结算, 殖民, 殖民地, 沉降 [医] 居住区; 沉渣
several	a. 几个的, 一些的, 各自的 pron. 几个
severe	a. 严格的, 尖锐的, 严肃的, 严重的, 严厉的, 朴素的 [法] 严厉的, 苛刻的, 严重的
sewage	n. 脏水, 污水 [医] 污水, 污物
sewer	n. 下水道, 阴沟, 裁缝师 vt. 用下水道排, 铺设下水道于
sex	n. 性别, 性欲 vt. 区别...的性别, 引起...的性欲
shabby	a. 衣衫褴褛的, 低劣的, 破旧的, 吝啬的, 卑鄙的
shaft	n. 轴, 箭杆, 矛, 矿井 vt. 装杆于, 利用
shallow	n. 水浅的地方, 浅滩 a. 浅的, 肤浅的 v. (使)变浅
shamble	vi. 蹒跚地走, 摇摇晃晃地走, 摇晃不稳 n. 蹒跚
shanty	n. 棚屋
sharp	n. 半升音调, 利刃, 骗子 a. 锋利的, 明显的, 敏锐的, 急剧的, 尖刻的, 严厉的, 刺耳的, 精明的 adv. 锐利地, 急速地
shatter	n. 碎片, 粉碎, 落叶, 喷洒 vt. 打碎, 使散开, 粉碎, 破坏 vi. 粉碎, 损坏, 脱落
shave	n. 修面, 刮胡子, 幸免, 剃刀 vt. 修面, 剃, 修剪, 掠过 vi. 刮脸, 勉强通过
shear	n. 修剪, 剪下的东西, 大剪刀, 切变, 剪切机, 切 vt. 修剪, 割, 剥夺, 横越, 削剪 vi. 剪, 修剪, 剪羊毛, 切断
shed	n. 车棚, 小屋, 脱落之物, 分水岭 vt. 使流出, 放射, 脱落, 散发, 摆脱 vi. 流出, 散布, 脱落
sheep	n. 羊, 胆小者
sheer	a. 绝对的, 全然的, 纯粹的, 透明的, 峻峭的 vi. 偏转, 偏航 vt. 使急转向, 使偏航 adv. 完全, 全然, 峻峭 n. 偏航
sheet	n. 床单, 张, 纸张, 印刷品, 裹尸布, 薄片 vt. 盖上被单, 遍布 vi. 大片落下 a. 片状的, 成薄片的 [计] 工作表
shelf	n. 架子, 搁板 [化] 架子
shell	n. 贝壳, 壳, 外形, 炮弹 vt. 去壳, 脱落, 炮轰 vi. 剥落, 脱壳 [计] 外壳; DOS内部命令:指定命令行处理程序
shelter	n. 庇护所, 避难所, 庇护, 隐蔽处, 掩蔽 vt. 庇护, 保护, 隐匿 vi. 躲避
shepherd	n. 牧羊人, 牧羊犬, 牧师, 保护者 vt. 看守, 领导, 指导, 牧羊
shield	n. 盾, 防卫物, 保护者, 屏蔽 vt. 保护, 遮蔽, 屏蔽, 庇护, 挡开, 避开 vi. 起保护作用
shift	n. 变化, 移动, 轮班, 手段, 应急办法, 移位 vt. 替换, 转移, 改变, 推卸, 变速 vi. 转换, 移动, 转变, 推托, 变速 [计] DOS内部命令:该命令可将批处理参数向左移动一个位置
shimmer	n. 微光, 闪光 vi. 闪烁 vt. 使闪烁
ship	n. 船, 舰 vt. 以船运送, 装船, 运送 vi. 上船, 乘船
shiver	vi. 颤抖, 哆嗦, 被打碎 vt. 使迎风飘动, 粉碎 n. 战栗, 碎块
shoal	n. 浅水, 浅滩, 沙洲, 鱼群, 暗礁, 潜在危险 a. 浅的 vi. 鱼成群而游, 变浅 vt. 使变浅
shock	n. 震动, 冲突, 震惊, 冲击, 突击, 禾束堆, 休克, 长毛狗 vt. 使震动, 使休克, 使受电击, 震惊得 vi. 震动, 吓人 a. 蓬乱浓密的
shoes	n. 鞋子（shoe的复数）
shop	n. 商店, 工厂, 车间 vi. 购物, 到处寻找 vt. 选购
shopping	n. 买东西, 购物 [经] 购物, 买东西
short	a. 短的, 近的, 矮的, 短期的, 简短的, 少量的 adv. 简短地, 突然 n. 扼要, 短片, 缺乏 vt. 故意少给, 使短路
shortage	n. 不足, 缺乏 [化] 缺额
shovel	n. 铲, 铁铲 v. 铲
shower	n. 阵雨, 淋浴, 一阵, 展出者, 显示者 vi. 淋浴, 下阵雨 vt. 淋湿, 倾注
shred	n. 碎布条, 细片, 少量 v. 撕碎
shrewd	a. 精明的, 锐利的, 剧烈的, 机灵的, 厉害的
shrink	n. 收缩, 萎缩, 回避 vi. 收缩, 退缩, 萎缩, 缩小, 回避 vt. 使收缩, 使缩小
shrub	n. 矮树, 灌木, 果汁甜酒
shrug	n. 耸肩 v. 耸肩
shutter	n. 百叶窗, 关闭物, 照相机快门, 关闭者 vt. 为...装百叶窗, 以百叶窗遮闭
shuttle	n. 穿梭, 梭子, 往返移动之物 v. (使)穿梭移动, 往返运送
sick	n. 病人 a. 不舒服, 有病的, 恶心的, 厌恶的, 渴望的, 病态的 vt. 呕吐, 追击, 使(狗)去攻击
sicken	vt. 患病, 使厌倦, 使恶心 vi. 生病, 作呕
sickness	n. 疾病, 不健康, 呕吐 [医] 病
side	n. 旁边, 侧, 方面, 胁, 侧边, 血统 a. 旁的, 侧的, 次要的 vt. 同意, 支持 vi. 支持, 赞助
siege	n. 包围, 围攻, 再三的努力 vt. 包围, 围攻
sieve	n. 筛子, 滤网 vt. 筛, 滤
sigh	n. 叹息 vi. 叹息, 渴望 vt. 叹息着说
sight	n. 景观, 视力, 眼界, 阅读, 见解, 意见 vt. 看见, 瞄准 vi. 瞄准, 观看 a. 即席的, 见票即付的
sightseeing	n. 观光, 游览 a. 观光的, 游览的
sign	n. 符号, 招牌, 征兆, 正负号, 手势 vt. 签名, 打手势表达 vi. 签名 [计] 正负号; 符号; 符号字符
signal	n. 信号, 暗号, 近因, 导火线 vt. 向...作信号, 标志, 用信号通知 vi. 发信号 a. 作为信号的, 显著的 [计] 信号
signature	n. 签字, 识别标志, 调号 [计] 签名附件
significant	a. 重要的, 有效的, 有含义的, 暗示的, 值得注意的
signify	vt. 象征, 预示 vi. 要紧, 重要
silence	n. 沉默, 无声, 静寂, 湮没, 无声息 vt. 使缄默 interj. 安静
silent	a. 沉默的, 安静的, 无声的, 静止的 [医] 静止的, 无症状的
silver	n. 银, 银币, 银器 a. 银的, 银制的, 银器的 vt. 镀银 vi. 变银白色
similar	a. 相似的, 类似的 n. 相似的东西
simple	a. 简单的, 普通的, 朴素的, 单纯的, 绝对的, 初级的, 原始的, 迟钝的 n. 出身低微者, 傻子
simplify	vt. 单一化, 简单化
simulate	vt. 模拟, 假装, 模仿 [法] 伪装的, 模拟的; 假装的, 伪装的, 冒充
simultaneous	a. 同时的, 同时发生的 [计] 同时的
sincere	a. 诚实的, 正直的, 真挚的, 纯净的
single	a. 单身的, 单程的, 单一的, 个别的, 孤独的, 专一的 n. 一个, 单打, 单程票 vt. 选出 vi. 击出一垒打 [计] 单精度型
singular	n. 单数 a. 异常的, 单一的
sink	n. 藏垢的场所, 沟渠, 污水槽 vi. 下沉, 沉没, 下陷, 减弱, 衰退, 消沉, 堕落, 渗透 vt. 使低落, 使下沉, 陷于, 投入(资金等), 挖掘
site	n. 位置, 场所, 地点 vt. 给...择址
sites	n. 遗址, 举办地点；网站（site的复数）
situated	a. 位于...的, 坐落在...的, 处于某种境地的 [法] 坐落...的, 位于...的, 处于某种境地的
size	n. 大小, 尺寸, 规模, 尺码, 能力, 浆料 vt. 上浆, 依大小排列 vi. 可比拟 a. 一定大小的, 一定尺寸的
sizes	n. 象素显示尺寸, 尺寸（size复数形式）
skating	n. 溜冰
skeleton	n. 骨骼, 骨瘦如柴的人, 梗概, 骨干, 残骸 a. 骨骼的, 概略的, 基层的, 骨干的 [计] 骨架
sketch	n. 素描, 草图, 小品 v. 描绘略图, 画素描或速写
skiing	n. 滑雪运动, 滑雪术
skill	n. 技术, 技巧, 技能, 熟练, 熟练工人 [化] 技能
skills	n. 技术；技能；技巧（skill的复数形式）
skim	vt. 撇取浮沫, 略读, 掠过 vi. 擦过, 浏览 n. 脱脂乳, 擦过, 表层物 a. 撇去浮沫的
skin	n. 皮肤, 皮 vt. 剥皮, 在...植皮 vi. 长皮, 愈合, 蜕皮
skip	n. 跳跃, 跳读 vi. 跳越, 跳读, 跳绳, 遗漏, 跳级 vt. 跳过, 遗漏 [计] 跳过
skirt	n. 裙子, 下摆, 边缘, 郊区 vt. 位于...边缘, 绕过, 回避 vi. 位于边缘
slab	n. 平板, 厚片 vt. 切成厚板, 以平板盖上
slack	n. 松弛, 松懈, 淡季, 闲散, 家常裤 a. 松弛的, 不流畅的, 疏忽的, 无力的, 呆滞的, 软弱的, 漏水的 adv. 马虎地, 缓慢地 vt. 放松, 使缓慢 vi. 松懈, 减弱, 松弛
slag	n. 熔渣, 矿渣, 无足轻重的人 vt. 使变成熔渣 vi. 变熔渣
slam	n. 砰然声, 猛然, 猛烈的抨击 vt. 猛然关上, 砰地关上, 猛烈抨击 vi. 砰地关上, 猛攻
slander	n. 中伤, 诽谤 vt. 中伤, 诽谤
slang	n. 俚语 v. 辱骂, 用俚语说
slap	n. 掴, 掌击, 侮辱, 拍击声 v. 拍击, 惩罚 adv. 正面地, 直接地, 突然地
slate	n. 板岩, 页岩, 提名名单, 人选, 记录, 石板 a. 石板色的 vt. 铺石板, 责骂, 痛打
slaughter	n. 残杀, 屠杀, 杀戮 vt. 残杀, 屠杀, 亏本出售
sleep	n. 睡眠, 静止, 昏迷, 麻木, 长眠, 冬眠 vi. 睡觉, 睡眠, 静止 vt. 睡
sleeping	n. 睡眠 a. 睡着的
sleepy	a. 困乏的, 欲睡的
slender	a. 苗条的, 纤弱的, 微少的, 微薄的 [机] 细的, 纤细的
slice	n. 薄的切片, 一部分, 菜刀 vt. 切成薄片, 切下 vi. 切 [计] 片
slide	n. 滑, 滑道, 山崩, 雪崩, 幻灯片 vt. 使滑动, 偷偷放入 vi. 滑动, 滑落, 不知不觉陷入, 偷偷地走
slight	n. 轻蔑, 怠慢 a. 轻微的, 纤细的, 脆弱的, 苗条的 vt. 轻视, 忽略, 怠慢
slim	a. 瘦的, 苗条的, 微小的, 稀少的, 微薄的 vi. 变苗条 vt. 使苗条
slip	n. 滑, 滑行, 事故, 溜, 差错, 滑台, 下降, 插条, 后裔, 板条, 瘦长的年轻人 vi. 滑动, 滑倒, 失足, 溜走, 滑落, 犯错, 变坏 vt. 使滑动, 滑过, 摆脱, 闪开, 塞入, 从...取接枝 a. 滑动的, 滑移的, 活络的, 有活结的 [计] 串行线接口协议
slippery	a. 滑的, 光滑的, 靠不住的, 圆滑的, 不稳固的 [法] 狡猾的, 不可靠的, 不安定的
slit	n. 裂缝, 投币口, 狭长裂口 vt. 切开, 扯裂, 使有狭缝 vi. 纵切, 纵裂
slogan	n. 呐喊声, 标语, 口号
slope	n. 倾斜, 斜坡, 斜率, 扛枪姿势 vt. 使倾斜, 弄斜, 扛 vi. 倾斜, 走, 逃走
slot	n. 水沟, 细长孔, 硬币投币口, 缝, 狭槽, 狭通道, 位置, 一档(广播节目等) vt. 开槽于, 把...纳入机构 [计] 槽; 存储槽
sluggish	a. 偷懒的, 懒惰的, 迟钝的 [经] 萧条的, 呆滞的
slum	n. 贫民窟 vi. 访问贫民区
smart	a. 聪明的, 漂亮的, 刺痛的, 剧烈的, 敏捷的, 巧妙的, 伶俐的, 潇洒的 n. 刺痛, 痛苦 vi. 刺痛
smash	n. 打碎, 粉碎, 打碎时哗啦声, 猛击, 扣球, 杀球, 经营失败, 破产, 硬币, 假硬币 a. 非常轰动的, 了不起的 vt. 打碎, 粉碎, 击溃, 使破产, 使裂变, 使用假硬币 vi. 碎裂, 猛撞, 破产, 扣球, 杀球 adv. 轰隆一声, 哗啦一声
smelly	a. 发臭的, 有臭味的
smoke	n. 烟, 雾气, 烟熏剂, 抽烟, 烟色 vi. 吸烟, 冒烟, 弥漫 vt. 以烟熏, 抽烟而导致...
smokers	n. 吸烟者( smoker的名词复数 )
smoking	n. 抽烟, 冒烟 [医] 烟熏; 吸烟
smooth	a. 平滑的, 平稳的, 流畅的, 和蔼的, 安祥的, 圆滑的, 调匀的, 无毛的 vt. 使光滑, 烫平, 使平和, 消除 vi. 变平滑, 变平静 n. 一块平地, 平滑部分
smother	vt. 使喘不过气, 使窒息, 闷熄, 忍住, 抑制, 覆盖 vi. 窒息, 被抑制 n. 浓烟, 窒息状态, 杂乱无章
smuggle	vt. 偷运, 走私, 私运 vi. 走私
snack	n. 小吃, 点心, 快餐 vi. 吃零食, 吃快餐
snacks	n. 快餐；小吃；零嘴（snack的复数）
snatch	n. 抢夺, 攫取, 片断 vt. 夺取, 攫取 vi. 想抢走, 攫取
soak	n. 浸, 湿透, 大雨 vt. 使上下湿透, 浸, 吸入, 吸收, 浸洗掉 vi. 浸泡, 渗透
soar	n. 高扬, 翱翔 vi. 往上飞舞, 高耸, 翱翔
sober	a. 未醉的, 稳重的, 节制的, 严肃的, 不夸大的, 合理的, 朴素的 vt. 使醒酒, 使严肃 vi. 从醉里醒来, 变严肃
sociable	a. 好交际的, 社交的, 过社会生活的 n. 联谊会
social	a. 社会的, 群居的, 社交的 n. 联欢会
sociology	n. 社会学 [医] 社会学
soil	n. 土壤, 土地, 国家, 国土, 温床, 污物, 粪便, 水池 vt. 弄脏, 污辱 vi. 变脏
solar	a. 太阳的, 日光的, 源自太阳的 [医] 太阳的; 腹腔丛的
sole	n. 脚掌, 鞋底, 底部 a. 唯一的, 仅有的, 单独的, 独身的 vt. 上鞋底, 触底
solemn	a. 严肃的, 郑重的, 庄严的
solidarity	n. 团结, 团结一致, 共同一致 [法] 团结, 共同责任
solitary	n. 独居者 a. 孤独的, 独居的
solo	n. 独奏, 独唱, 单独表演 a. 单独的, 独奏的, 独唱的 vi. 放单飞
soluble	a. 溶解的, 可溶解的, 可以解决的 [医] 溶解的, 可溶的
solution	n. 解决, 解答, 溶液 [化] 溶液
solve	vt. 解决, 付给, 溶解 vt. 求解 vi. 求解 [计] 求解
solvent	n. 溶剂 a. 有偿付能力的, 有溶解力的
somehow	adv. 不知何故
somewhat	n. 某物, 几分 adv. 多少, 几分
sophisticated	a. 复杂的, 久经世故的 [法] 尖端的, 高级的, 非常有经验的
sore	a. 悲伤的, 痛的, 引起痛苦的 n. 痛处, 溃疡, 疮
sort	n. 种类, 方式, 品质, 态度, 举止 vt. 分类, 排序, 挑选 vi. 交往, 协调 [计] 排序; DOS外部命令:从标准输入设备接收数据, 整个数据输入完后 对它以行为单位进行排序, 然后在标准输出设备上输出
sound	n. 声音, 语音, 吵闹, 声调, 听力范围, 探条, 海峡 a. 健全的, 可靠的, 合理的, 健康的, 彻底的, 资金充实的 adv. 彻底地, 充分地 vi. 发出声音, 回响, 测深, 试探, 听起来 vt. 使发声, 宣告, 听诊, 测...深, 试探 [计] 声音
soundproof	a. 隔音的
sour	a. 酸的, 酸臭的, 发酵的, 愠怒的, 讨厌的, 拙劣的, 不健全的 vi. 变酸, 发酵, 厌烦, 变坏 vt. 使变酸, 使失望 n. 酸味, 酸饮料
source	n. 来源, 水源, 根源, 原始资料, 源 [计] 来源, 源程序
sources	n. 输入源；发起者；来源（source的复数）
souvenir	n. 纪念品
souvenirs	n. 纪念品( souvenir的名词复数 )
sovereign	n. 元首, 独立国 a. 具有主权的, 至高无上的, 国王的, 完全的
sow	n. 母猪, 懒胖女人 vt. 播种, 散布, 使密布 vi. 播种
space	n. 位置, 空间, 距离, 太空, 空白, 间隔, (期刊等的)篇幅 vt. 隔开, 分隔 vi. 留间隔 [计] 空白, 空格校验
spacious	a. 广大的, 宽广的
Spain	n. 西班牙
span	n. 指距, 全长, 跨距, 一段时间, 小范围 vt. 以手指测量, 跨越, 架设, 持续
Spanish	n. 西班牙人, 西班牙语 a. 西班牙的
spare	n. 剩余, 备用品, 备件, 备用零件, 备用轮胎 a. 多余的, 备用的, 空闲的, 节约的, 瘦的 vi. 节约, 省掉, 宽恕 vt. 节约, 省用, 剩下, 饶恕, 赦免
spark	n. 火花, 火星, 闪光, 无线电报务员, 瞬间放电, 活力, 朝气, 花花公子, 情郎 vi. 闪光, 发火花, 求婚 vt. 发动, 鼓舞, 使有朝气, 求婚
sparkle	n. 闪耀, 火花, 活力, 发泡 vi. 闪耀, 冒火花 vt. 使闪耀
sparse	a. 稀疏的, 稀稀落落的, 稀薄的
spatial	a. 空间的, 受空间条件限制的, 占地位的 [医] 隙的, 间隙的, 腔的; 空间的, 立体的
speaker	n. 说话人, 讲演者, 发言人, 喇叭, 扬声器 [计] 扬声器
speaking	n. 谈话, 演说 a. 讲话的, 适于说的, 讲某种语言的
special	n. 专辑, 专车, 号外, 特别的东西, 负有特别任务的人员 a. 特别的, 专门的, 特殊的, 额外的, 附加的, 特别亲密的
speciality	n. 专长, 擅长, 特种技能, 详细说明, 特性, 特产, 专业 [化] 特制品
specialize	vt. 使特殊化, 列举, 特别指明, 限定...的范围 vi. 成为专家, 专攻
species	n. 种, 类, 外形 [医] 茶剂; 种
specific	n. 特效药, 特性 a. 特殊的, 明确的, 具有特效的, 特定地, 具体地
specification	n. 规格, 详述, 详细说明书 [计] 规范; 形式说明; 说明; 说明书; 规格
specimen	n. 样品, 标本, 试料 [化] 试样
spectacle	n. 引人羡慕的东西, 景象, 眼镜, 场面, 公开展示
spectacular	a. 公开展示的, 惊人的, 壮观的 n. 奇观, 惊人之举, 展览物
spectator	n. 观众, 目击者, 旁观者
spectrum	n. 光谱, 范围, 系列 [化] 光谱
speculate	vi. 深思, 推测, 投机 [经] 投机
speech	n. 演讲, 说话, 谈话, 言语, 引语, 民族语言 [医] 言语, 语言
speed	n. 速率, 速度, 迅速 vi. 加速, 超速, 快进 vt. 快速传送, 促进, 使加速 [计] 中央处理机速度设置程序
spending	n. 经费, 开销 [经] 开支, 开销, 经费
sphere	n. 球, 球面, 球体, 天体, 地球仪, 范围 vt. 包围, 使成球体, 放入球内
spider	n. 蜘蛛, 设圈套者 [化] 星形轮
spill	n. 溢出, 溅出, 摔下, 溢出量, 木片, 小塞子 vt. 使溢出, 使散落, 洒, 使流出, 倒出, 使摔下 vi. 溢出, 涌流, 摔下
spin	n. 旋转, 自旋, 疾驰, 情绪低落 vt. 纺织, 纺, 使旋转, 编造 vi. 纺纱, 吐丝, 作茧, 结网, 旋转, 自旋, 疾驰
spiral	n. 螺旋形之物, 螺线 a. 螺旋形的, 盘旋的 vi. 螺旋形下降, 螺旋形上升, 螺旋形行进 vt. 使螺旋形行进
spiritual	a. 精神上的, 神圣的, 崇高的, 高尚的, 鬼的, 招魂术的 n. 有关教会的事
spit	n. 唾液, 唾吐, 小雨, 炙叉, 一铲的深度 vt. 唾吐, 吐出, 降小雨, 用炙叉穿过 vi. 吐唾沫, 吐痰, 唾弃, 飘霏霏细雨
splash	n. 飞溅, 污点, 一点儿, 溅泼声, 色斑 vi. 溅湿, 溅开, 飞溅 vt. 溅, 泼, 使溅起水, 洒, 使成斑驳状
splendid	a. 光亮的, 了不起的, 灿烂的, 壮丽的, 显著的, 杰出的
split	n. 劈开, 裂片, 裂缝, 分裂, 派系, 派别, 柳条 a. 劈开的 vi. 分离, 分开, 裂开, 被劈开 vt. 劈开, 切开, 使分裂, 使分离 [计] 拆分
spoil	n. 战利品, 赃物, 奖品, 变质, 次品 vt. 损坏, 破坏, 溺爱 vi. 腐坏, 掠夺
spokesman	n. 发言人, 代言者
sponge	n. 海绵, 海绵状的东西 vt. 用海绵擦拭, 吸收掉, 抹掉 vi. 采集海绵, 海绵般吸收
sponsor	n. 保证人, 赞助者, 发起者, 倡议者, 教父 vt. 发起, 赞助, 倡议
spontaneous	a. 自然的, 自发的, 未经琢磨的 [医] 自发的, 特发的, 自生的
spoons	n. 匙, 调羹( spoon的名词复数 ); 一匙的量
sporadic	a. 偶尔发生的, 零星发生的, 分散的 [医] 散在的, 散发的
sport	n. 运动, 游戏, 娱乐, 消遣, 玩笑 a. 运动的, 户外穿戴的 vi. 游戏, 参加体育运动, 戏弄, 产生变种 vt. 炫耀, 使产生变种
sports	n. (英)运动会, 运动的, 适用于运动的, 运动会的, 与运动会有关的
sportsman	n. 运动员, 冒险家
sportswear	n. 运动装, 休闲服
spot	n. 污点, 地点, 斑点, 点, 娱乐场所, 处境, 少量 a. 当场的, 现场的, 现货买卖的, 现金交易的, 抽样的 vt. 点缀, 玷污, 认出, 准确定...的位, 用灯光照射 vi. 玷污, (从空中)侦察敌方目标
spotlight	n. 照明灯, 反光灯, 聚光灯
spouse	n. 配偶
sprawl	vi. 伸开手足躺, 爬行, 蔓生, 蔓延 vt. 懒散地伸开, 使蔓生, 使不规则地伸展 n. 伸开手足躺卧姿势
spray	n. 水沫, 浪花, 水花, 喷雾, 喷雾器, 小树枝 vt. 喷雾, 扫射, 喷射 vi. 喷, 溅开
spring	n. 春天, 弹簧, 跳跃, 弹性, 活力, 泉, 源泉 a. 春天的 vi. 跳, 弹跳, 涌出, 生长, 裂开, 高耸 vt. 使跳起, 使爆炸, 突然提出
sprint	n. 短距离赛跑 vi. 全速跑, 冲刺 vt. 全速跑过
sprout	n. 芽, 萌芽 vt. 使发芽, 摘去芽 vi. 长芽, 抽条
spur	n. 马刺, 刺激物, 鼓舞 vt. 刺激, 激励, 用马刺策(马)前进 vi. 用马刺驱马, 疾驰
square	n. 正方形, 街区, 广场, 平方, 直角尺 a. 正方形的, 正直的, 公正的, 平方的, 方正的, 结清的 adv. 成直角地, 对准地 vi. 一致, 符合, 结清 vt. 使成方形, 使平方自乘, 调正, 结清, 使一致
squeeze	n. 紧握, 挤, 榨, 榨取, 佣金 vt. 紧握, 挤, 榨取 vi. 压榨, 榨
stability	n. 安定, 稳定性, 坚实, 巩固 [化] 稳定性
stabilize	vt. 使安定, 使稳固 vi. 稳定, 安定
stack	n. 堆叠, 堆, 大量, 书库, 枪架, 烟囱, 堆积, 存贮栈 vt. 堆积, 堆满, 暗中对...做手脚 vi. 堆起 [计] 堆积, 堆栈
stadium	n. 露天大型运动场 [医] 期, 病期
staff	n. 全体人员, 工作班子, 棍棒, 杆, 拐杖, 支柱, 权杖 a. 职员的, 雇员的, 参谋的 vt. 为...配备人员
stage	n. 阶段, 舞台, 场所, 戏剧, 站, 驿站, 级, 层, 脚手架 vt. 上演, 表演, 筹划 vi. 适于上演, 乘驿车旅行
stagger	n. 蹒跚, 踌躇 vi. 蹒跚, 犹豫 vt. 使摇摆, 使踌躇, 交错, 错开 a. 交错的, 错开的
stagnant	a. 不流动的, 停滞的, 不景气的, 萧条的, 污浊的, 迟钝的 [经] 萧条的
stain	n. 污染, 污点, 着色剂 vt. 沾染, 染污, 着色 vi. 变脏
stairs	n. 楼梯
stake	n. 桩, 炮烙刑, 木柱, 赌注, 奖金 vt. 打桩, 用桩撑, 下赌注, 资助 vi. 打赌
stale	n. 尿 a. 不新鲜的, 陈腐的, 疲惫的, 陈旧的 vt. 使变旧, 走味 vi. 变陈旧, 走味, 失时效, 撒尿
stall	n. 厩, 停车处, 牧师职位, 货摊, 托辞, 拖延 vt. 关入厩, 停顿, 推托, 支吾, 使陷于泥中 vi. 被关在厩内, 陷于泥中, 停止, 支吾
stand	n. 站立, 站住, 停顿, 讲台, 看台, 立场, 法院证人席 vi. 站, 立, 坐落, 停滞, 位于, 坚持, 维持原状 vt. 忍受, 使站立, 抵挡
standard	n. 标准, 规格, 旗, 军旗, 本位 a. 标准的, 合规格的 [计] 标准
standards	n. 标准；规格（standard的复数）
standing	n. 起立, 持续, 身分 a. 立着的, 不动的, 经常的, 持续的
staple	n. 主要产物, 常用品, 主要要素, 原料, 订书钉, 钩环 a. 主要的, 重要的 vt. 分级, 钉住
star	n. 星, 恒星, 星形物, 运气, 明星 vt. 以星状物装饰, 用星号标, 使成为明星 vi. 变成明星
starch	n. 淀粉, 浆糊, 刻板 vt. 浆硬
starter	n. 开端者, 在起跑线上的人, 参加赛跑的人, 调度员, 起动机, 酵母 [计] 启动程序, 启动器
starting	n. 开端, 开始, 出发, 起动, 开动 [机] 开动, 起动
startle	n. 惊愕, 惊恐 vt. 吃惊, 使惊愕 vi. 惊起
starve	v. (使)饿死, (使)挨饿
statement	n. 陈述, 指令, 声明 [计] 程序语句; 语句
States	n. 美国
statesman	n. 政治家
static	n. 静电, 静电干扰 a. 静态的, 静止的, 固有的, 静电的
station	n. 车站, 站, 局, 驻地, 位置, 身分, 地位 vt. 安置, 配置, 驻扎 [计] 站
stationary	a. 不动的, 静止的, 不变的, 固定的, 停留的 [计] 定常, 定态, 固定的
stationery	n. 文具, 信纸 [法] 文具
stations	n. 车站；驻地；位置（station的复数形式）
statistics	n. 统计学, 统计资料 [计] 统计信息
statue	vt. 以雕像装饰 n. 雕像
status	n. 状态, 情形, 地位, 要人身份 [计] 状态
statute	n. 法令, 成文法律, 法规, 章程, 条例 [法] 法令, 法规, 成文法
steadfast	a. 坚定的, 踏实的, 固定的, 不变的
steady	a. 稳定的, 不动摇的, 沉着的, 稳固的, 坚定的, 经常的 vt. 使稳定, 使坚定 vi. 变为沉着, 稳固
steak	n. 牛排, 鱼排, 肉排
steam	n. 蒸汽, 精力 a. 蒸汽的 vi. 蒸发, 行驶, 发怒 vt. 蒸, 煮, 散发
steamer	n. 汽船, 蒸汽机 [化] 蒸汽发生器; 蒸汽机
steel	n. 钢, 钢制品, 钢铁, 坚硬, 坚固 a. 钢的, 钢制的, 钢铁业的, 坚强的 vt. 使坚强, 钢化, 使冷酷
steep	n. 浸渍, 悬崖 a. 险峻的, 陡峭的, 急剧升降的, 夸大的 v. 浸, 泡
steer	vt. 引导, 驾驶, 航行, 控制 vi. 驾驶, 掌舵, 行驶 n. 驾驶指示, 劝告
steering	n. 掌舵, 操纵, 指导
stem	n. 茎, 干, 柄, 船首, 血统, 堵塞物 vt. 摘掉茎, 装柄于, 阻止, 堵住, 逆行 vi. 堵住, 逆行
steps	n. （楼外的）台阶；步伐；步幅；步数
stereo	n. 铅版, 立体照片 a. 立体的, 立体感觉的
stereotype	n. 铅版, 陈规, 老套 vt. 使用铅版, 把...印制成盲文, 套用老套, 使一成不变
sterilize	vt. 使成不毛, 使绝育, 杀菌, 使不起作用 [医] 灭菌, 消毒; 绝育
sterling	n. 英国货币, 标准纯银 a. 英国货币的, 标准纯银的, 含标准成分的
stern	n. 尾部, 船尾, 臀 a. 严厉的, 严格的, 坚定的, 坚决的
steward	n. 管理人, 招待员, 管家, 乘务员 [经] 轮船, 飞机的服务员, (财务)管理员
stick	n. 棍, 棒, 刺, 枯枝, 茎, 条状物 vt. 插进, 刺入, 钉住, 伸出, 粘贴, 停止 vi. 粘住, 停留, 坚持, 陷住, 伸出
stiff	a. 坚硬的, 严厉的, 呆板的, 生硬的, 刚强的, 强烈的, 粘的, 稠的, 艰难的 n. 死尸, 醉鬼, 钞票 vt. 不肯付...小费
stimulate	vt. 刺激, 激励, 鼓舞 vi. 起刺激作用
stimulus	n. 刺激, 激励, 刺激品 [医] 刺激特, 刺激
sting	n. 叮, 刺痛, 刺激, 讽刺 vt. 叮, 刺痛, 刺激, 使苦恼 vi. 叮, 刺痛
stipulate	v. 规定, 保证
stitch	n. 一针, 疼痛, 针法, 碎布条, 针脚 v. 缝, 缝合, 装订
stock	n. 树干, 祖先, 血统, 原料, 备料, 库存, 牲畜, 股票, 股份, 保留剧目 a. 存货的, 常备的, 平凡的, 普通的, 股票的, 保留剧目的, 繁殖用的 vt. 装把手于, 进货, 备有, 放牧 vi. 出新芽, 备货, 囤积
stomach	n. 胃, 食欲, 欲望, 肚子 vt. 吃下, 忍受
stone	n. 石头, 宝石, 果核, 纪念碑, 结石 vt. 投扔石子, 铺石头 a. 石的, 石制的, 完全的
stones	n. 小石头；石子（stone的复数）
stoop	n. 佝偻, 屈从, 弯腰 vi. 弯下, 屈从, 弯腰, 堕落 vt. 使屈从, 使弯曲
storage	n. 存储器, 储藏, 保管, 库存, 仓库 [计] 存放处; 存储
store	n. 商店, 贮藏, 仓库, 备用品, 存储器 vt. 储存, 贮藏, 供给 vi. 贮藏 a. 贮藏的, 现成的 [计] 存储器操作; 存储
storehouse	n. 仓库, 储藏所, 宝库 [机] 库房, 贮藏库, 仓库
stores	n. (英)百货商店 a. 贮藏的, 用作贮藏处的, 贮存的
storey	n. 楼, 楼层, 层楼
story	n. 故事, 小说, 传奇, 描述, 阅历, 经历, 层
straightforward	a. 笔直的, 率直的, 明确的, 简单的, 直接的
strain	n. 紧张, 拉紧, 张力, 过劳, 扭伤, 血缘, 种, 族, 气质, 曲调, 旋律, 口吻 vt. 使劳累, 拉紧, 过分使用, 扭伤, 滥用, 曲解, 滤 vi. 尽力, 努力, 紧拉, 弯曲, 被滤出
strait	n. 海峡, 困境 a. 困难的, 窘迫的, 狭窄的
strap	n. 带, 皮带 vt. (用皮带)捆扎
strategic	a. 战略的, 战略上的 [经] 战略的
strategy	n. 战略, 策略 [经] 战略, 策略
street	n. 街道, 马路, 街区 a. 街道的
strength	n. 力量, 实力, 强度, 浓度, 人数, 抵抗力 [化] 强度
strengthen	vt. 加强, 变坚固 vi. 变强, 股票上涨
strenuous	a. 奋发的, 费劲的, 艰苦的
stress	n. 压力, 紧迫, 强调, 重音, 重点, 应力 vt. 加压力于, 着重, 重读
stressful	a. 着重, 强调, 重读, 使受应力
stretch	n. 伸展, 张开, 连绵, 一段路, 一段时间 a. 可伸缩的, 弹性的 vt. 伸展, 张开, 曲解, 使过度伸展 vi. 伸展, 延伸 [计] 伸展
stride	n. 大步, 步幅, 步态, 进步 v. 迈大步走, 跨过, 跨
strike	n. 罢工, 打击, 殴打 vt. 打, 撞击, 冲击, 侵袭, 取消, 结算, 打掉, 罢工, 刺透, 使生根, 遇见 vi. 打, 打击, 抓, 罢工, 搏动, 触礁, 敲, 响, 穿透, 打动
striking	a. 醒目的, 惊人的, 打击的, 罢工的 [法] 罢工的, 罢市的, 罢课的
string	n. 线, 细绳, 一串, 字符串 vt. 串起, 成串, 收紧, 缚, 扎 vi. 成一串 [计] 字符串, 串
strip	n. 长条, 条状, 带, 脱衣舞 vt. 脱衣, 被剥去, 剥夺, 拆卸 vi. 脱衣服
stripe	n. 斑纹, 条纹 [医] 纹, 条纹
strive	vi. 努力, 奋斗, 斗争
stroke	n. 笔划, 打, 中风, 抚, 摩, 冲程 vt. 划尾桨, 抚, 摩, 划去 [计] 笔划
stronger	[经] 强劲的
structural	a. 结构的, 建筑的 [医] 结构的
stubborn	a. 顽固的, 不听话的, 执拗的, 棘手的
student	n. 学生, 研究者, 学者
studies	n. 研究；学习；学业（study的复数）
studio	n. 工作室, 画室, 演播室, 电影制片厂
study	n. 学习, 研究, 学科, 论文, 求学, 书房, 试作 vt. 学习, 读书, 研究, 考虑, 计划 vi. 学习, 思索
stuff	n. 原料, 要素, 东西, 材料, 素质, 织品, 废物, 废话 vt. 装填 vi. 狼吞虎咽
stumble	n. 绊倒, 蹒跚而行, 失足 vt. 使绊倒, 使困惑 vi. 绊倒, 失足, 失策, 犯错, 蹒跚, 踌躇
sturdy	a. 强健的, 健全的 [医] 羊晕倒病, 羊蹒跚病
style	n. 风格, 时尚, 文体, 风度, 字体, 类型 vt. 称呼, (根据新款式)设计, 使合潮流 n. 风格, 样式 [计] 风格, 样式
styles	n. 风格；样式；模式（style的复数形式）
subcommittee	n. 小组委员会
subdue	vt. 使服从, 压制, 减弱, 抑制, 克制
subject	n. 科目, 主题, 臣民, 主语, 题目, (事物的)经受者, 学科, 受治疗者, 原因, 理由 a. 服从的, 易患...的, 隶属的, 受支配的 adv. 在...条件下 vt. 使隶属, 使受到 [计] 主题, 主体
subjective	a. 主观的, 个人的 [医] 主观的, 自觉的
subjects	n. 主题；被试者；学科；科目（subject的复数）
submarine	n. 潜水艇, 海底生物 a. 海中的, 生长在海中的 vt. 用潜水艇攻击 vi. 在下疾行, 在下滑动
submerge	vt. 使浸水, 使陷入, 淹没 vi. 潜入水中
submit	vt. 使服从, 使受到, 委托, 提交, 认为 vi. 屈服, 服从
subordinate	n. 属下, 附属物 a. 下级的, 次要的, 附属的 vt. 使居下位, 使服从
subscribe	vt. 捐献, 签署 vi. 赞成, 同意, 捐款, 预订, 认购 [计] 订阅
subsequent	a. 后来的, 接下去的 [经] 后来的
subside	vi. 沉淀, 沉降, 平息
subsidiary	n. 子公司, 附件, 辅助者 a. 辅助的, 次要的, 津贴的
subsidy	n. 补助金, 津贴 [经] 补助金, 津贴, 补贴
substantial	n. 重要材料(或事物), 有实际价值的东西 a. 实质上的, 物质的, 有内容的, 结实的
substantiate	vt. 使实体化, 证实 [经] 确证
substitute	n. 代理, 代理人, 代用品, 代替者, 代替物 vt. 代替 vi. 替代, 取代, 代用 a. 代替的, 代用的, 代用品的 [计] 置换; 替代
subtitle	n. 副标题
subtitles	n. 说明字幕, 印在外国影片上的对白翻译字幕, 译文对白字幕
subtle	a. 敏锐的, 精细的, 狡猾的, 稀薄的, 灵巧的, 微妙的 [医] 锐敏的; 精细的
subtract	vt. 减去, 扣掉, 减少 vi. 做减法 [计] 减
suburb	n. 市郊住宅区, 郊区, 边缘
successful	a. 成功的, 一帆风顺的, 顺利的 [经] 成功的
succession	n. 连续, 继承权, 继位, 演替, 地层次序 [法] 继承, 继承权, 继位
succinct	a. 简洁的, 紧缩的
succumb	vi. 屈从, 屈服, 死
suck	vt. 吸, 吮, 吸入, 吮吸, 吸收 vi. 吸, 吸奶 n. 吸, 吸入, 吮吸
sue	vt. 控告, 起诉, 请求 vi. 提出诉讼, 提出请求
sufficient	a. 充分的, 足够的 [法] 充分的, 足够的
sugar	n. 糖, 糖块, 甜言蜜语 vt. 加糖于, 使甜蜜, 粉饰, 美化 vi. 制成糖
suggestion	n. 提议, 意见 [医] 暗示
suggestions	n. 民众意见箱；员工意见箱
suicide	n. 自杀, 自杀者 v. 自杀 a. 自杀的
suit	n. 套装, 诉讼, 请求, 起诉, 套, 组 vt. 适合, 使适应 vi. 合适, 相称
suitable	a. 适当的, 相配的 [法] 合适的, 适宜的, 适当的
suitcase	n. 手提箱
suite	n. 随员, 套房, (一)组, (一)套, 组曲, 继之而来的事 [电] 程序组
sulphur	n. 硫, 硫磺 [化] 硫
summary	n. 摘要, 概要 a. 摘要的, 简略的 [计] 摘要; 概要
summer	n. 夏季, 全盛时期 vi. 避暑, 过夏天 [计] 加法器
summit	n. 顶点, 最高阶层, 最高级会议 a. 政府首脑的, 最高级的
summon	vt. 召唤, 召集, 号召, 振奋, 唤起, 鼓起 [经] 传唤, 传讯
Sunday	n. 星期日 a. 星期日的, 业余的 vi. 度星期日
sundial	n. 日规, 日晷
sunlight	n. 日光 [医] 日光, 太阳光
superb	a. 极度的, 华丽的, 极好的
superficial	n. 表面, 外表 a. 表面的, 肤浅的, 面积的
superfluous	a. 多余的, 过剩的
superintend	v. 指挥, 管理, 监督
superior	n. 长者, 占优势的人, 上级 a. 上级的, 出众的, 高傲的
supermarket	n. 超级市场 [经] 超级市场, 自助售货商店
supersede	vt. 代替, 取代, 接替 [法] 替代, 替换, 充任
supersonic	a. 超声波的 [医] 超声[波]的
superstition	n. 迷信 [法] 迷信
superstructure	n. 上部构造, 上层建筑 [化] 超结构
supervise	v. 监督, 管理, 指导
supervisor	n. 管理者, 监督者, 指导者, 视导员 [计] 管理程序
supplementary	a. 补足的, 补充的, 追加的 [经] 追加的, 补充的, 增补的
supply	n. 补给, 供给, 供应品 vt. 补给, 供给, 提供, 补充 vi. 替代
support	n. 支持, 支撑, 援助, 供养, 支撑物 vt. 支援, 支撑, 帮助, 支持, 忍受, 供养, 证实 [计] 后援; 支持
supposedly	adv. 想象上, 看上去像, 被认为是, 恐怕, 按照推测
supposition	n. 想像, 推测, 推想 [法] 假定, 推定, 推测
suppress	vt. 镇压, 使止住, 禁止, 抑制, 查禁 [法] 镇压, 平定, 禁止出版
supreme	n. 至高, 霸权 a. 至高的, 终极的, 极端的, 最大的
surcharge	n. 装载过多, 超载, 追加罚款, 附加税 vt. 使装载过多, 追加罚款, 收附加税
surface	n. 面, 表面, 水面, 外表, 平面 a. 表面的, 外观的, 肤浅的, 水面上的 vt. 使成平面, 使浮出水面 vi. 浮出水面, 呈现, 在地面上工作
surge	n. 巨涌, 汹涌, 澎湃 vi. 汹涌, 澎湃, 颠簸, 猛冲, 突然放松 vt. 使汹涌奔腾, 急放 [计] 电压尖峰
surgeon	n. 外科医生, 军医, 船医 [医] 外科医师
surgery	n. 外科, 手术, 手术室, 换球术
surmount	vt. 战胜, 超越, 克服
surname	n. 姓, 别号, 绰号 vt. 呼以姓氏, 起绰号
surpass	vt. 超越, 凌驾, 胜过
surplus	n. 剩余, 过剩, 盈余 a. 过剩的, 剩余的
surprise	n. 惊奇, 奇袭, 诧异 vt. 使惊奇, 撞见, 奇袭
surrender	vt. 交出, 放弃, 使投降, 让与 vi. 投降, 自首 n. 交出, 放弃, 投降
surroundings	n. 环境, 周围的事物 [化] 环境
survey	n. 纵览, 视察, 测量, 俯瞰, 调查 vt. 审视, 视察, 俯瞰, 通盘考虑 vi. 测量土地
survival	n. 生存, 残存, 幸存者 a. 赖以生存的
susceptible	a. 易受影响的, 易感动的, 容许...的 [法] 易感的, 易受影响的, 容许
suspect	n. 被怀疑者, 嫌疑犯 a. 令人怀疑的, 不可信的, 可疑的 v. 怀疑, 猜想
suspend	vt. 悬, 吊, 使悬浮, 暂停, 中止, 推迟 vi. 暂停, 中止, 悬浮, 停止偿付债务 [计] 暂停
suspense	n. 悬疑, 焦虑, 悬念, 悬而不决 [经] 未定, 暂记
suspension	n. 悬挂, 暂停, 中止 [化] 悬浮; 悬浮体; 悬浮液
suspicious	a. 可疑的, 多疑的, 怀疑的 [法] 怀疑的, 令人怀疑的, 可疑的
sustain	vt. 承受, 支持, 供养, 继续, 忍受, 蒙受, 证实, 准许 [电] 持续
sustenance	n. 生活资料, 生计, 食物, 支持 [法] 营养物, 维持, 支持
swallow	n. 燕子, 吞咽, 喉 vt. 咽, 淹没, 吞没, 耗尽, 轻信, 忍受, 抑制 vi. 吞下, 咽下
swamp	n. 沼泽, 进退两难的困境 vt. 淹没, 击溃, 清除, 使陷于沼泽 vi. 陷于沼泽, 淹没
swarm	n. 群, 大群, 蜂群, 分蜂群 vi. 分群, 群集, 聚集一块, 云集, 攀 vt. 挤满, 爬, 攀
sway	n. 摇摆, 影响力, 支配 vt. 摇动, 支配, 弄歪, 使倾斜, 使动摇, 影响 vi. 摇动, 摇摆, 倾斜, 动摇, 统治, 转向
swear	vt. 发誓, 咒骂, 使宣誓 vi. 发誓, 诅咒 n. 诅咒, 誓言
sweater	n. 毛衣, 毛线衫, 运动衫, 出汗者 [化] 发汗器
sweep	n. 扫除, 打扫, 肃清, 视野, 范围, 全胜 vt. 扫除, 掸去, 猛拉, 扫荡, 肃清, 冲走, 刮起, 环视, 掠过, 扫射 vi. 扫, 打扫, 袭击, 席卷, 扫视, 掠过
swell	n. 增大, 隆起的部分, 巨浪, 肿胀 a. 优秀的, 一流的 vi. 增大, 膨胀, 肿胀, 增强, 骄傲 vt. 使膨胀, 使增大, 使上涨, 使骄傲
swerve	n. 转向, 弯曲, 背离 vi. 突然转向, 转弯, 背离 vt. 使突然转向, 使转弯, 使背离
swift	n. 褐雨燕, 快速爬行的小蜥蜴, 蝙蝠蛾, 大滚筒 a. 迅速的, 快的, 敏捷的, 立刻的 adv. 迅速地, 敏捷地 [计] Swift 程序设计语言，用于开发 Mac OS X / iOS 程序
swimming	n. 游泳, 眩晕
swing	n. 摇摆, 振幅, 音律, 节奏, 涨落, 秋千, 旋转, 行动自由 vi. 摇摆, 悬挂, 旋转, 大摇大摆地走, 转向 vt. 挥舞, 使旋转, 使转向, 悬挂, 吊运 a. 旋转的, 悬挂的, 强节奏爵士音乐的
swirl	n. 漩涡, 涡动 vt. 使成漩涡 vi. 打漩, 盘绕, 眩晕
switch	n. 开关, 电闸, 转换, 软枝, 鞭子, 道岔 vt. 转变, 切换, 摆动, 转换, 使转轨 vi. 转换, 变换, 摆动 [计] 交换机；开关; 翻转; 转移
sydney	n. 悉尼（澳大利亚港市）
syllabus	n. 摘要, 提纲, 课程表, 教学大纲 [医] 摘要, 要目
symbolize	vt. 符号化, 用符号表现 vi. 采用象征, 使用符号
symmetry	n. 对称, 匀称 [化] 对称; 对称性; 对称现象
sympathetic	a. 有同情心的, 合意的, 赞成的 n. 交感神经, 容易感受的人
symphony	n. 交响乐, 交响曲
symposium	n. 讨论会, 座谈会, 专题报告会, 专题论文集
symptom	n. 症状, 征候, 征兆 [医] 症状
synchronize	vt. 使同步, 使合拍 vi. 同时发生 [计] 同步
syndicate	n. 企业联合, 辛迪加, 财团 v. 联合成辛迪加
synonym	n. 同义词
synthesis	n. 综合, 组织, 综合体 [化] 合成
synthetic	n. 合成物质 a. 综合(性)的, 人造的, 合成的
system	n. 系统, 体系, 制度, 方式, 秩序, 分类原则 [计] 系统; 体制; 体系
systematic	a. 有系统的, 分类上的, 体系的 [医] 系统的, 系的, 分类的
systems	n. 体制, 体系；制度；系统（system的复数形式）
table	n. 桌子, 餐桌, 工作台, 铭文, 表格, 表, 高原, 平地层 vt. 搁置, 嵌合, 制表, 把...列入议事日程 [计] 表格, 模拟运算表
tables	n. 桌子；附录；表格（table的复数）
tablet	n. 平板, 门牌, 笔记簿, 碑, 匾, 药片 [化] 片剂
tablets	n. 药片( tablet的名词复数 ); （木、竹）简; 碑; 一块肥皂
taboo	n. 禁忌, 禁止接近, 禁止使用 a. 禁忌的, 忌讳的 vt. 禁忌, 忌讳, 禁止
tacit	a. 沉默寡言的, 不苟言笑的, 缄默的
tackle	n. 工具, 复滑车, 滑车, 装备, 扭倒 vt. 固定, 处理, 抓住 vi. 扭倒
tactic	n. 一项战术, 一条策略 a. 战术的, 顺序的, 排列的
tag	n. 标签, 附属物, 碎片, 结束语, 口头禅, 附加语, 浑名, 标记, 标记符 vt. 附以签条, 尾随, 添饰, 起浑名, 连接 vi. 紧紧跟随 [计] 标记
take	vt. 拿, 取, 抓, 带领, 获得, 就座, 接受, 吃, 吸引, 采取, 乘, 需要, 花费 vi. 吃掉对方棋子, 抓住, 起作用, 依法获得财产 n. 拿, 取, 收成, 奏效
talented	a. 天资高的, 有才能的
tame	a. 驯服的, 柔顺的, 被开垦的, 顺从的, 乏味的, 平淡的 vt. 驯养, 驯服, 制服, 失去锋芒 vi. 变得驯服
tamper	vi. 干预, 拨弄, 贿赂, 损害, 篡改 vt. 篡改 n. 捣棒, 打夯机, 填塞者
tangible	n. 可触知的东西, 有形资产 a. 可触摸的, 有实体的, 非相像的, 有形的, 明确的
tangle	n. 缠结, 纠结的一团, 困惑, 纠纷, 混乱 vt. 使缠结, 缠住 vi. 缠结, 乱作一团
tap	n. 轻打, 水龙头 vt. 轻打, 轻敲, 敲打出, 选择, 装上嘴子, 使流出, 开发, 分接, 向...乞讨 vi. 轻叩, 轻拍, 啪塔啪塔地走 [计] 接头
tape	n. 带子, 录音带, 磁带, 窄带, 卷尺 vt. 以带子绑起, 测量, 录音 [计] 带
tar	n. 焦油, 柏油, 水手 vt. 涂以焦油, 玷污, 怂恿 a. 焦油的
target	n. 目标, 靶子, 指标 vt. 对准, 订指标
tariff	n. 关税, 关税表, 价格表, 收费表 vt. 课以关税 [计] 价目表
tarnish	n. 失泽, 失泽膜, 污点 vt. 使失去光泽, 玷污 vi. 失去光泽, 被玷污
taxation	n. 课税, 征税, 抽税, 税款, 估定的税额 [经] 征税, 纳税, 税制
taxi	n. 出租车 vi. 乘出租车 vt. 用出租车送
tea	n. 茶, 茶叶 [医] 茶, 茶剂, 浸剂
teacher	n. 教师, 老师, 导师
teaching	n. 教学, 学说, 教导
team	n. 队, 组 vt. 把马(牛)套在同一辆车上, 把...编成一组 vi. 驾驶卡车, 协作
teams	n. 团队, 参赛队伍（team的复数形式）
tear	n. 泪滴, 眼泪, 撕, 扯, 裂缝, 激怒, 飞奔 vi. 流泪, 撕破, 赶快, 飞奔, 被撕破 vt. 撕裂, 戳破, 拉掉, 撕掉, 使分裂, 使精神不安, 折磨
tease	n. 揶揄, 戏弄, 逗惹 vt. 戏弄, 取笑, 强求, 梳理, 使起毛
technical	a. 技术上的, 专门的, 工业的, 严格根据法律的 [化] 技巧
technician	n. 技师 [化] 技师
technique	n. 技巧, 技术, 方法 [化] 工艺方法; 技巧
techniques	n. 方法；技巧；技术（technique的复数）
technology	n. 技术, 工业技术, 术语 [医] 技术学, 工艺学
tedious	a. 沉闷的, 冗长乏味的
teem	vi. 充满, 充足, 倾注 vt. 倒出
teeth	pl. 牙齿 [医] 牙
telephone	n. 电话, 电话机 v. 打电话
telescope	n. 望远镜 vi. 叠缩, 嵌进, 缩短 vt. 使叠缩, 使缩短
television	n. 电视 [电] 电视
telex	n. 用户直通电报, 电传打字机 [计] 电传, 用户电报
telling	a. 有效的, 显著的, 显露内心活动的
temper	n. (钢等的)硬度, 脾气, 心情, 中和剂, 倾向, 回火 vt. 使回火, 锻炼, 调和, 使缓和 vi. 回火
temperament	n. 气质, 性格, 性情 [医] 气质, 禀赋
temperate	a. 温和的, 适度的, 有节制的, 温带的
temperature	n. 温度, 发烧, 热度 [化] 温度
temple	n. 圣堂, 庙宇, 教堂, 礼拜堂, 太阳穴, 鬓角 [医] 颞颥, 颞部
temples	n. 边撑, 伸幅器；寺庙（temple的复数形式）
tempo	n. 速度, 节奏, 进行速度, (棋的)一着
temporary	a. 暂时的, 临时的 n. 临时工, 临时雇员 [计] 临时
temptation	n. 诱惑, 诱惑物 [法] 诱惑, 诱惑物
tenable	a. 可守的, 站得住(脚)的, 合理的, 成立的
tenacious	a. 紧握的, 固执的, 不屈不挠的, 黏着力强的 [医] 坚韧的
tenancy	n. 租用, 租赁 [经] 租赁, 租回
tendency	n. 趋向, 倾向 [医] 趋向, 趋势
tender	a. 嫩的, 柔软的, 脆弱的, 温柔的, 亲切的, 未成熟的, 微妙的, 棘手的, 审慎的 vt. 使变嫩, 提供, 偿还 vi. 变柔软, 投标 n. 照料, 看管人, 供应船, 小船, 提出, 偿付, 投标
tennis	n. 网球
tension	n. 紧张, 不安, 拉紧, 张力, 压力, 电压 vt. 拉紧, 使紧张
tentacle	n. 触须, 触手, 触角 [医] 触角, 触须
tentative	n. 试验 a. 试验性的, 暂时的
term	n. 术语, 专有名词, 期限, 学期, 任期, 条件, 价钱, 关系, 地位, 项, 界石 vt. 称, 呼 [计] 检索词; 项
terminal	n. 终端机, 终点, 末端, 极限, 终点站 a. 终点的, 定期的, 致死的, 结尾的, 末端的, 晚期的 [计] 终端; 终端设备
terminate	a. 有结尾的, (可)结束的 vi. 结束, 终止, 满期 vt. 使停止, 使结束, 使终止 [计] 终止
terms	n. 条件, 条款, 费用, 价钱, 关系, 地位, 交谊 [经] 条件
terrace	n. 阶地, 梯田, 房屋之平顶, 阳台, 沿岸防地, 露台 a. 叠层式的 vt. 使成梯田, 使成有平台屋顶
terrain	n. 地带, 地区, 地形, 领域, 范围
terrestrial	n. 地球上的人 a. 地球的, 陆生的, 陆地的, 人间的
terrific	a. 非常好的, 极端的, 可怕的
terrify	vt. 使恐惧, 恐吓
territorial	a. 领土的, 土地的, 地方的, 区域性的 n. 本土自卫队队员
territory	n. 领土, 领地, 版图, 地区, 活动范围 [经] (推销员等的)推销区域
terror	n. 恐怖, 可怕的人 [医] 惊吓, 惊悸
terse	a. 简洁的, 扼要的
tertiary	a. 第三的, 第三位的, 第三产业的 n. 第三修道会会员, 第三纪 第三的; 三代的(指无机盐)
test	n. 测试, 试验, 化验, 检验, 考验, 甲壳 vt. 测试, 试验, 化验 vi. 接受测验, 进行测试
testimony	n. 证言, 证据, 声明 [医] 证据
text	n. 文本, 正文, 课文, 主题, 圣经文句, 乐谱 [计] 电文; 文本; 正文
textbook	n. 教科书
textile	n. 纺织品, 纺织业 a. 织的, 纺织的
texture	n. (织物的)密度, (材料等的)结构, 纹理 [化] 纹理
thaw	n. 融解, 融化, 解冻时期 vt. 使融解, 使缓和 vi. 融化, 解冻
theatre	n. 戏院, 电影院, 剧场, 全体观众, 戏剧, 戏剧效果, 阶梯式讲堂, 场所
theft	n. 盗窃, 失窃, 盗窃罪, 赃物 [法] 盗窃行为, 偷窃, 失窃
theme	n. 主题, 话题, 题目
theoretical	a. 理论的, 理论上的, 假设的, 推理的 [计] 理论的
theory	n. 理论, 学说, 原理, 意见, 推测 [化] 理论
therapist	n. 治疗学家 [医] 治疗学家
therapy	n. 治疗 [医] 疗法, 治疗
thereby	adv. 因此
thermal	a. 热的, 热量的, 温泉的 n. 上升温暖气流
thermometer	n. 温度计, 体温计 [化] 温度计
thesaurus	n. 专类辞典, 宝库, 知识宝库, 叙词表, 主题词表 [计] 同义词, 同义词典
thesis	n. 论题, 论文
thief	n. 小偷, 贼 [化] 取样
thigh	n. 大腿, 股 [医] 股, 大腿
thinking	n. 思考, 思想 a. 思考的, 有理性的
third	num. 第三, 三分之一 [机] 第三; 第三的
thirst	n. 口渴, 渴望 vi. 口渴, 渴望
thorn	n. 刺, 棘, 荆棘
thorough	a. 十分的, 彻底的
thought	n. 想法, 思想, 思维, 关心, 挂念 think的过去式和过去分词
thoughtful	a. 深思的, 体贴的
thoughts	n. 思想；思维；想法（thought的复数）
thousand	num. 千 a. 成千的, 许多的 n. 许许多多
threats	n. 威胁, 恐吓( threat的名词复数 ); 可能造成威胁的人[事, 想法]; 恶兆, 兆头
threshold	n. 门槛, 入口, 开端, 阈 [计] 阈; 阈值
thrill	n. 震颤, 激动, 刺激性, 一阵激动 vi. 震颤, 颤抖, 激动 vt. 使激动, 使颤动
thriller	n. 使人激动的东西, 使人毛骨悚然的东西, 使人毛骨悚然的小说
thrive	vi. 繁荣, 兴旺, 茁壮成长 [经] 兴旺, 繁荣, 旺盛
throat	n. 咽喉, 喉咙, 嗓音 vt. 用喉音说, 开沟于
throng	n. 群, 人群, 群集, 众多 a. 拥挤的 vi. 群集, 蜂拥 vt. 在...群集, 使拥塞
throughout	adv. 到处, 贯穿全部地, 自始至终 prep. 遍及, 在各处 [计] 吞吐量
thrust	n. 插, 戳, 刺, 猛推, 口头攻击, 推力 vt. 插入, 猛推, 刺, 戳, 强加, 延伸 vi. 插, 刺, 戳, 延伸, (用力)推
thumb	n. 拇指 vt. 以拇指拨弄, 笨拙地摆弄, 用拇指翻旧, 迅速翻阅, 作搭车手势
thunder	n. 雷, 雷声 vi. 打雷, 轰隆地响, 怒喝 vt. 大声喊出, 轰隆地发出
Thursday	n. 星期四
tick	n. 滴答声, 一瞬间, 壁虱, 褥套, 信用, 赊欠 vi. 滴答响, 活动 vt. 滴答地记录, 标记号于
ticket	n. 票, 券, 车票, 标签, 入场券, 证明书 vt. 加标签于, 为...购票
tickets	n. 票；罚单（ticket的复数）
tide	n. 潮, 潮汐, 趋势, 潮流, 涨潮, 高潮 vt. 使随潮漂流 vi. 顺潮行驶
tidy	n. 椅子的背罩, 装杂物的容器 a. 整齐的, 有条理的 vt. 弄整齐, 收拾, 整理 vi. 整理, 收拾
tighten	vt. 勒紧, 使变紧 vi. 变紧, 绷紧
tile	n. 砖瓦, 瓷砖, 瓦片 vt. 铺以瓦, 铺以瓷砖 [计] 平铺
tiles	n. 瓷砖（tile的复数形式）
tilt	n. 倾斜, 倾向, 船篷, 车篷 vt. 使倾斜, 使倾侧, 用帆布篷遮盖 vi. 倾斜, 翘起, 冲, 评击 [计] 倾斜
timber	n. 木材, 木料 vt. 用木材建造
time	n. 时间, 时侯, 时机, 时期, 期限, 次数, 节拍, 暂停, 规定时间 vt. 测定...的时间, 记录...的时间, 计时, 定时 a. 时间的, 记时的, 定时的, 定期的, 分期的 [计] DOS内部命令:用于显示或设定系统的时间
timely	a. 及时的, 适时的 adv. 及时地
timetable	n. 时间表
timidity	n. 胆小, 胆怯, 羞怯
tinge	n. 色调, 色彩, 气味, 气息 vt. 染, 使带气息
tissue	n. 薄的织物, 薄纱, 棉纸, 组织, 一套 [化] 组织
title	n. 头衔, 名称, 标题, 书名, 扉页, 权利, 资格, 冠军, 字幕 vt. 授予头衔, 加标题于 [计] 标题
toast	n. 吐司, 烤面包, 干杯 vt. 敬酒, 烤, 使暖和 vi. 烤, 烘
toddle	vi. 东倒西歪地走, 蹒跚学步, 溜达 n. 东倒西歪的走路, 蹒跚
toil	n. 辛苦, 苦工, 网, 罗网, 圈套 vi. 苦干, 跋涉
token	n. 表征, 记号, 代币 a. 象征的, 表意的 [计] 记号
tolerable	a. 可容忍的, 可以的
tolerance	n. 宽容, 忍受, 容忍, 容许量, 公差 [计] 允许误差
toll	n. 通行费, 代价, 钟声 vt. 征收, 敲钟, 鸣钟, 勾引, 引诱 vi. 征税, 鸣钟
tones	n. 声调；基本音色（tone的复数）
tongue	n. 舌, 语言能力, 讲话方式, 语言 vt. 舔, 斥责, 发...的音 vi. 使用舌头, 吹管乐器
tonic	n. 补药, (音乐)主调音或基音 a. 滋补的, 声调的, 使精神振作的
tools	n. 工具, 工具菜单；工具箱（tool的复数形式）
top	n. 顶部, 顶端, 极点, 上面, 上部, 顶篷, 最高地位, 首位, 陀螺 a. 最高的, 顶上的, 头等的 vt. 盖, 加以顶, 高达, 超越 vi. 结束, 达到顶点, 高出 [计] TOP协议
topic	n. 主题, 论题, 话题
topics	abbr. 总联机程序和信息控制系统（Total On-line Program and Information Control System）
torch	n. 火把, 启发之物 [化] 火炬
torment	n. 使人痛苦的东西, 折磨者, 苦痛 vt. 使苦恼, 纠缠, 歪曲, 拷问
tornado	n. 旋风, 龙卷风, 大雷雨
torrent	n. 奔流, 倾盆大雨, 倾注, 迸发
torture	n. 拷问, 苦闷 vt. 拷问, 曲解, 折磨, 使弯曲
toss	n. 投掷, 抛, 摇摆, 震荡, 掷钱币决定 vt. 投掷, 猛抬, 摇荡, 使不安, 掷钱币决定 vi. 被到处扔, 摇摆, 颠簸, 辗转, 掷钱币决定某事
total	a. 全体的, 总的, 全然的 vt. 计算...的总和, 共计为 vi. 合计 n. 总数, 全体, 合计 adv. 统统
touching	a. 动人的, 令人同情的
touchy	a. 易怒的, 难以取悦的, 过于敏感的
tough	n. 恶棍 a. 强硬的, 艰苦的, 坚固的, 坚韧的, 粗暴的, 咬不动的
tour	n. 旅游, 观光旅行, 任期 vi. 旅行, 周游, 巡回 vt. 周游, 观光, 游历, 使巡回演出
touring	n. 游览 a. 游览的
tourism	n. 观光业, 游览 [经] 旅游业
tourist	n. 观光客, 旅行者 a. 旅游的
tourists	n. 旅行者, 观光客( tourist的名词复数 )
tournament	n. 比赛, 竞赛, 锦标赛, 联赛
tours	n. 图尔斯（姓氏）；图尔市（法国城市名）
tow	n. 拖, 拖绳, 拖轮 vt. 拖, 拉, 牵引
towel	n. 手巾, 毛巾 v. 擦干身子
tower	n. 塔, 高楼, 堡垒 vi. 高耸, 翱翔
town	n. 城镇, 市, 镇 [法] 城镇, 城市, 闹市
toxic	a. 有毒的, 中毒的 [医] 中毒的, 毒物的
toys	n. 玩具（toy的复数）
trace	n. 痕迹, 踪迹, 微量, 迹线, 缰绳 vt. 追踪, 回溯, 描绘 vi. 追溯, 沿路走
track	n. 轨迹, 足迹, 径迹, 小道, 轨道, 磁轨, 途径 vt. 循路而行, 追踪, 通过, 用纤拉 vi. 追踪, 留下足迹, 沿轨道运行 [计] 跟踪
tract	n. 大片土地, 地带, 小册子 [医] 束, 道
traction	n. 曳, 牵引, 牵引力 [医] 牵引
tractor	n. 牵引器, 拖拉机, 拉纸器 [计] 进纸器
trade	n. 贸易, 商业, 交易, 生意, 职业, 顾客, 信风 vi. 进行交易, 做买卖, 经商, 对换, 购物 vt. 用...进行交换
traditional	a. 传统的, 惯例的 [经] 传统的, 惯例的
traffic	n. 交通, 通行, 运输, 交通量, 贸易, 交易, 交往, 通信量 vi. 交易, 做买卖 vt. 用...作交换 [计] 通信量, 传输量
tragedy	n. 悲剧, 惨案, 悲剧作品 [法] 惨事, 灾难, 不辛
trail	n. 踪迹, 痕迹, 一串, 尾部, 小径, 持枪姿势 vt. 拖, 尾随, 追踪, 落后于, 开出路 vi. 拖曳, 垂下, 落后, 飘出, 蔓生
train	n. 火车, 列车, 行列, 长队, 一连串的后果, 顺序 vt. 训练, 教育, 对准 vi. 受训练, 锻炼
training	n. 训练, 培养 [医] 训练
trains	n. 火车；行列（train的复数形式）
trait	n. 特征, 特性, 一笔, 少许
traitor	n. 叛逆者, 叛国者 [法] 叛徒, 叛逆, 背信者
tramp	n. 坚实(或沉重)的脚步声, 流浪者 vi. 践踏, 重步行走, 步行, 流浪 vt. 走过, 踩
trample	n. 践踏(声), 蹂躏 v. 践踏, 无视
tranquility	n. 宁静
transaction	n. 交易, 办理, 学报, 和解协议 [计] 事务处理
transcend	vt. 超越, 胜过
transcript	n. 抄本, 副本, 成绩单 [法] 法院文本, 官方记录, 记录的副本
transfer	n. 迁移, 移动, 传递, 转让, 转移, 过户, 汇兑, 换车 vt. 使转移, 调转, 调任, 改变, 传递, 转让 vi. 转移, 转学, 转职, 换车 [计] 传送
transform	vt. 使转换, 改变, 改造, 使...变形 vi. 改变, 转化, 变换 [计] 变换
transfuse	vt. 输血, 充满 [医] 输血, 输液
transgress	vt. 违反, 犯罪, 侵犯 vi. 越界, 违法
transistor	n. 晶体管 [化] 晶体管
transit	n. 经过, 通行, 运输, 运输线, 转变 vt. 运送, 使通过, 经过 vi. 通过
transition	n. 转变, 转换, 变迁, 过渡时期, 临时转调 [化] 跃迁
translucent	a. 半透明的, 透明的
transmission	n. 传输, 传送, 变速器 [计] 传输
transparent	a. 透明的, 显然的, 清晰的 [计] 透明
transplant	vt. 使移居, 移植, 使迁移 vi. 移居, 耐移植 n. 移居者, 移植
transport	n. 运输, 运输工具, 激动, 狂喜, 流放犯 vt. 传送, 运输, 流放 [计] 传送
transportation	n. 运输, 输送, 交通车辆 [经] 运转, 运输, 运输费
trap	n. 圈套, 陷阱, 诡计, 存水弯 vi. 设圈套, 设陷阱 vt. 诱捕, 诱骗, 抓住, 使受限制 [计] 俘获; 陷井
trauma	n. 外伤, 损伤 [医] 创伤, 外伤
travel	n. 旅行, 游历, 行进 vi. 旅行, 行进, 移动, 被传播 vt. 旅行, 通过, 使移动
travelers	n. 旅行者；旅客（traveler的复数形式）
traveling	a. 旅行的, 旅行用的, 移动的
traverse	n. 越过, 横贯, 横断物, 屏障, 否认, 反驳 vt. 横过, 穿过, 经过, 详细研究, 反对, 在...来回移动 vi. 横越, 横断, 旋转, 来回移动 a. 横亘的, 横贯的
treatise	n. 论文, 专著
treatment	n. 治疗, 待遇, 处理 [医] 疗法, 治疗; 处理
treaty	n. 条约, 谈判 [经] 协议, 协定, 协商
treble	n. 最高声部, 三倍 a. 三倍的, 最高声部的 vt. 使增为三倍 vi. 成为三倍
tree	n. 树, 木料, 树状物 vt. 把...赶上树 [计] 树; DOS外部命令:显示指定磁盘驱动器的目录结构
trees	n. 树木；乔木；树状结构（tree的复数）
trek	vi. 牛拉货车, 艰苦跋涉 n. 牛车旅行, 艰苦跋涉
tremble	n. 战栗, 颤抖 vi. 战栗, 忧虑, 摇晃
tremendous	a. 巨大的, 非常的, 可怕的
trench	n. 渠, 沟渠, 战壕 vt. 在...开沟, 挖战壕于, 用战壕围住 vi. 挖战壕, 开沟
trend	n. 趋势, 倾向, 走向 vi. 倾向, 转向 [计] 趋势
trends	n. 动态, 趋势
trespass	n. 擅自进入, 非法侵入, 侵害 vi. 侵害, 侵入, 打扰, 冒犯
trial	n. 审判, 试验, 艰苦, 麻烦事, 考验 a. 审讯的, 试验性的
triangle	n. 三角形, 三个一组, 三角关系 [医] 三角, 三角形
tribe	n. 宗族, 部落, 一群人 [医] 族(生物分类)
tributary	a. 支流的, 纳贡的, 从属的, 辅助的 n. 支流, 纳贡者, 属国
tributes	n. （尤指旧时一国向他国交纳的）贡品( tribute的名词复数 ); （良好效果或影响的）体现; （尤指对死者的）致敬; 称赞
trick	n. 诡计, 欺诈, 谋略, 恶作剧, 习惯, 决窍 vt. 愚弄, 欺骗, 装饰 vi. 哄骗, 戏弄 a. 有决窍的, 特技的, 欺诈的, 漂亮的, 靠不住的
trickle	n. 滴, 细流 vi. 滴, 细细地流 vt. 使滴, 使小量流动 [计] 信息透露
trifle	n. 琐事, 少量 vt. 浪费 vi. 开玩笑, 翻弄, 虚度光阴
trigger	n. 触发器, 扳机 vt. 触发, 发射, 引起 vi. 松开扳柄 [计] 切换开关
trim	n. 整齐, 情形, 修剪 a. 整齐的 vt. 使整齐, 整理, 修剪 vi. 调整, 见风使舵 [计] 库存管理检查规则程序
trinity	n. 三人一组, 三个一组的东西, 三位一体
trip	n. 旅行, 绊倒, 摔倒, 失足, 差错, 旅程 vt. 使跌倒, 使犯错, 使失败 vi. 轻快地走, 绊倒, 失误, 犯错, 结巴, 旅行, 远足
triple	n. 三倍数, 三个一组 a. 三倍的 vt. 使增至三倍 vi. 增至三倍
triumph	n. 凯旋, 胜利, 欢欣 vi. 得胜, 成功
trivial	a. 琐碎的, 不重要的, 轻微的, 平常的
trolley	n. 电车, 手推车, 台车 vt. 用手推车运 vi. 乘电车
tropic	n. 回归线
trouble	n. 烦恼, 麻烦, 困难, 动乱, 故障 vt. 困扰, 麻烦, 使烦恼, 折磨 vi. 烦恼, 费心
troupe	n. 团, 班, 一伙 vi. 巡回演出
trousers	pl. 裤子, 长裤
truant	n. 懒惰的人, 玩忽职守者, 旷课者 a. 偷懒的, 旷课的, 游荡的 vi. 偷懒, 旷课
truce	n. 停战, 休战 vi. 停战, 休止 vt. 以休战结束
trumpet	n. 喇叭, 小号, 喇叭声 vi. 吹喇叭 vt. 用喇叭吹出, 吹嘘
trunk	n. 树干, 干线, 躯干, 主干, 象鼻, 箱子 vt. 把...放入旅行箱内 a. 树干的, 躯干的, 干线的, 箱形的 [计] 中继线; 母线
trustworthy	a. 可信赖的 [法] 可信任的, 可靠的, 可信赖的
tube	n. 管, 软管, 隧道 vt. 把...装管, 使通过管子 [计] 管子
tuck	n. 缝褶, 活力, 鼓声, 船尾突出部, 食品 vt. 打褶, 卷起, 挤进, 塞, 收藏 vi. 缝褶裥, 缩拢
Tuesday	n. 星期二
tug	n. 用力拉, 拖曳, 苦干, 挣扎, 绳索 v. 用力拉
tuition	n. 学费, 讲授
tumble	n. 跌倒, 摔跤, 翻斤斗 vi. 翻倒, 摔倒, 倒塌, 滚动, 翻斤斗, 仓促地行动 vt. 使摔倒, 使滚翻, 弄乱
tumour	n. 瘤, 肿块
tumult	n. 骚动, 吵闹, 混乱 [法] 骚乱, 骚动, 暴乱
tune	n. 歌曲, 主旋律, 心情, 声调, 和谐, 一致, 语调, 程度 vt. 为...调音, 调整, 调谐, 使一致 vi. 协调, 调谐
tunnel	n. 隧道, 地下道 vi. 挖隧道 vt. 掘隧道于
tunnels	n. 隧道, 地道( tunnel的名词复数 ); （动物栖息的）穴
turbulent	a. 狂暴的, 骚乱的, 紊乱的
turf	n. 草皮, 泥炭, 跑马场 vt. 覆草皮于
turmoil	n. 骚动, 混乱
turning	n. 旋转, 转弯处, 车削工作 [化] 车削
turnover	n. 翻倒, 翻转, 半圆酥饼, 营业额, 流通, 周转 a. 可翻转的
tutor	n. 家庭教师, 导师, 助教, 监护人 vt. 当...的教师, 教, 指导, 约束, 克制 vi. 当家庭教师, 受家庭教师的指导
tutorial	n. 个别指导, 论文, 学习指南, 指导手册 a. 个别指导的, 家庭教师的, 辅导的 [计] 教程
TV	电视 [计] 电视, 转移向量
tweezers	n. 镊子
twig	n. 小枝, 细枝 v. 懂得, 了解
twilight	n. 暮光, 曙光, 黎明, 黄昏, 微光, 朦胧状态 a. 微明的
twinkle	n. 闪烁, 闪耀, 瞬息 vi. 闪烁 vt. 使闪耀
twist	n. 一扭, 扭曲, 曲折, 歪曲, 螺旋状, 新手法 vt. 拧, 扭, 捻, 编织, 使扭转, 缠绕, 盘绕, 歪曲, 使转动, 使苦恼, 使混乱, 使旋转 vi. 转向, 弯曲, 缠绕, 扭动, 呈螺旋形
type	n. 类型, 样式, 典型, 榜样, 标志, 符号, 型, 式 vi. 打字 vt. 作为代表, 测定类型, 用打字机打 [计] 类型; 键入; DOS内部命令:在屏幕上显示指定文件的内容
types	v. 打字（type的第三人称单数形式）
typhoon	n. 台风
typical	a. 典型的, 象征性的 [医] 典型的
tyrannical	a. 暴虐的, 暴君的, 残暴的
tyre	n. 轮胎 vt. 装轮胎于
ugly	a. 丑陋的, 邪恶的, 险恶的, 不祥的 n. 丑陋的人(或物)
ultimately	adv. 最后, 最终 [法] 最后, 终究, 总之
ultimatum	n. 最后通牒, 基本原理 [法] 最后通牒, 哀的美敦书, 最后结论
ultraviolet	a. 紫外线的 [化] 紫外线的; 紫外线
unanimous	a. 意见一致的, 无异议的
uncomfortable	a. 不舒服的, 不自在的, 不安的
unconditional	a. 无条件的, 无限制的, 绝对的 [经] 无条件的, 无保留的
unconscious	a. 未意识到的, 无意识的, 无知觉的 [医] 人事不省的, 神志丧失的; 无意识的
unconvincing	a. 不足以令人相信的
underestimate	n. 低估 vt. 低估, 看轻
undergo	vt. 遭受, 经历, 忍受 [法] 经受, 经历, 忍受
undergraduate	n. 大学本科生, 大学肄业生 a. 大学生的
underground	n. 地下, 地铁, 地道, 秘密活动 a. 地下的, 秘密的 adv. 在地下, 秘密地
underline	vt. 在...下面划线, 作...的衬里, 强调 n. 下划线, 图下说明文字 [计] 加下划线; 下划线
underlying	a. 在下面的 [经] 优先的, 基础的, 放在下面的
undermine	vt. 在...下面挖, 渐渐破坏, 暗地里破坏 [法] 暗中破坏, 以阴谋中伤伤害
underneath	adv. 在下面 prep. 在...的下面
understanding	n. 理解, 谅解 [法] 协商, 协议, 谅解
undertake	vt. 试图, 从事, 保证, 承担, 同意, 接受 [化] 承包; 承担
underwrite	vt. 签名于下, 给...保险 vi. 经营保险业
undo	vt. 解开, 取消, 破坏, 毁灭, 扰乱 vi. 松开 [计] 撤消
undoubtedly	adv. 无疑, 必定, 确实地
undue	a. 不适当的, 过度的, 未到期的 [经] 未到(支付)期的
uneasy	a. 心神不安的, 不自在的, 不稳定的, 不舒服的
unemployment	n. 失业, 失业人数 [经] 失业
uneven	a. 不平坦的, 不均等的, 奇数的
unfair	a. 不公平的, 不正直的, 不正当的 [法] 不正直的, 不公平的, 偏颇的
unfold	vt. 展开, 打开, 披露, 开展, 挑明 vi. 伸展, 开花, 呈现
ungainly	a. 难看的, 不优雅的, 粗陋的
unhealthy	a. 不健康的
uniform	n. 制服 a. 统一的, 一律的, 始终如一的
unify	v. 统一, 使成一体
unilateral	a. 单方面的, 单边的, 片面的 [医] 单侧的, 一侧的
union	n. 联盟, 联合, 结合, 工会 [化] 联合; 联管节; 活接头
unique	a. 独一无二的, 独特的, 稀罕的
united	a. 联合的, 团结的, 一致的, 和睦的 [法] 联合的, 统一的, 一致的
universal	a. 全世界的, 普遍的, 宇宙的, 通用的 n. 一般概念
universities	n. 大学( university的名词复数 )
unlikely	a. 不太可能的
unravel	vt. 阐明, 解决, 解开 vi. 散开
unreliable	a. 不可靠的 [法] 不可靠的, 靠不住的
unrest	n. 不安的状态, 动荡的局面 [医] 不安
unsocial	a. 非社会的, 厌恶社交的, 不喜交际的, 孤僻的
untold	a. 未说过的, 未透露的, 未加叙述的, 数不清的, 无限的, 不可计量的, 无数的 [法] 未说明的, 未方露的, 未说出的
unusual	a. 不寻常的, 罕见的, 与众不同的
up-to-date	a. 直到现在的, 最近的, 现代化的 [化] 最新的
update	vt. 更新, 使现代化 n. 更新 [计] 更新
uphold	vt. 支撑, 赞成, 鼓励, 举起, 坚持 [法] 确认, 赞成, 支持
upkeep	n. 维持, 维修费 [经] 维修费, 养护费, 保养
upright	a. 正直的, 诚实的, 公正的, 垂直的, 竖式的 [化] 立杆
uprising	n. 起义, 升起 [法] 起义, 暴动
upset	a. 弄翻的, 混乱的, 心烦的 vt. 弄翻, 颠覆, 推翻, 打乱, 使不适, 使心烦 vi. 翻倒
urchin	n. 淘气鬼, 顽童
usage	n. 用法, 使用, 习惯, 惯用法, 习惯法 [经] 使用情况, 使用用途, 惯例
useful	a. 有用的, 有益的 [机] 有用的, 有效的
useless	a. 无用的, 无效的, 无益的 [机] 无用, 无价值, 无效
usual	a. 平常的, 通常的
utensils	n. 器具, 用具, 器皿( utensil的名词复数 ); 器物
utility	n. 功用, 有用之物, 实用, 公用事业, 实用程序 a. 实用的, 有多种用途的 [计] 实用程序, 工具
utmost	n. 极限, 最大限度, 极度 a. 极度的, 最远的
utterly	adv. 完全地, 全然, 绝对
vacancies	n. 空缺额；缺位（vacancy复数）
vacancy	n. 空, 空白, 空缺, 空虚, 空闲 [化] 空位
vacation	n. 假期, 休假 [法] 假期, 停审期, 休庭期
vaccine	n. 牛痘苗, 疫苗 a. 疫苗的, 牛痘的
vacuum	n. 真空, 空间, 真空吸尘器 a. 真空的, 产生真空的, 利用真空的 vt. 用吸尘器打扫
vain	a. 无价值的, 徒然的, 空虚的, 自负的, 愚蠢的
validity	n. 有效性, 正确性 [计] 有效性
valley	n. 山谷, 溪谷, 流域, 凹地 [医] 谷
valuation	n. 评价, 估价, 价值判断 [经] 估价, 计价, 评价
value	n. 价值, 价格, 购买力, 评价, 估价, 计算结果 vt. 评价, 估价, 重视 [计] 计算结果
valve	n. 活瓣, 阀, 活门 v. 装阀, 用阀调节
vanish	vi. 消失, 不见, 成为零
vanity	n. 虚荣心, 虚无, 自负, 空虚, 时髦的小摆饰
vanquish	vt. 打败, 征服, 克服 [法] 征服, 战胜, 击败
variable	n. 易变的事物, 变数, 可变物, 变量 a. 可变的, 不定的, 易变的, 变量的 [计] 变量
variant	n. 变体, 异体 a. 不同的, 有差别的 [计] 变体型
variation	n. 变更, 变化, 变种, 变奏 [医] 变异, 变易; 变度
varied	a. 不同的, 杂色的, 各式各样的 [法] 不同的, 种种的, 变化的
variety	n. 多样, 种类, 变种, 杂耍 [化] 变种
various	a. 不同的, 各种的, 多方面的, 许多的, 个别的, 杂色的 [法] 不同的, 种种的, 各式各样的
vary	vt. 改变, 使多样化 vi. 变化, 有不同, 违反
vegetable	n. 蔬菜, 植物, 无精打采之人 a. 蔬菜的, 植物的
vegetarian	n. 素食者, 食草动物 a. 素食的
vegetation	n. 植物 [医] 贽生物, 贽疣, 增殖体; 生长, 增殖
vehement	a. 热烈的, 激烈的
vehicle	n. 交通工具, 车辆, 传播媒介 [化] 载体; 运载体; 漆料
veil	n. 面纱, 面罩, 借口, 幕, 帐, 遮蔽物 vt. 戴面纱, 隐藏, 遮蔽, 掩饰 vi. 蒙上面纱
vein	n. 血管, 静脉, 纹理, 气质, 情绪 vt. 使有脉络, 像脉络般分布于
velocity	n. 速度, 迅速 [化] 速度
velvet	n. 天鹅绒 a. 天鹅绒的
venerate	vt. 尊敬, 崇敬, 崇拜
vengeance	n. 复仇, 报仇 [法] 报仇, 复仇
vent	n. 排气口, 出口, 通风孔, 发泄 vt. 发泄, 排出, 给...开孔
ventilate	vt. 使空气流通, 使通风, 公开讨论, 公开 [医] 通风, 换气
venture	n. 冒险, 风险 vt. 敢于, 冒...的危险 vi. 冒险
verbal	a. 用言辞的, 言语的, 口头的, 逐字的, 动词的 [医] 言语的, 口述的
verdict	n. 裁决, 判决, 判断性意见, 定论, 结论 [法] 定论, 判断, 意见
verge	n. 边缘, 边界, 起始点 vi. 处在边缘, 接近, 下沉, 趋向
versatile	a. 多才多艺的, 万用的, 万向的
versed	a. 熟练的, 精通的
version	n. 一种描述, 版本, 译文 [计] 版本
versus	prep. 对... [法] 诉, 对, 相形
vertical	a. 垂直的, 直立的 [医] 垂直的, 顶的, 头顶的
vessel	n. 船, 容器, 脉管 [医] 管, 脉管, (容)器
veteran	n. 老手, 退伍军人, 老兵, 老树 a. 老兵的, 老练的, 经验丰富的
veterinarian	n. 兽医 [医] 兽医
veto	n. 否决权 vt. 否决, 禁止
vex	vt. 使烦恼, 使苦恼 vi. 烦恼
via	prep. 经由, 经过, 通过 [医] 病毒灭活剂
viable	a. 能养活的, 能生长发育的 [医] 有活力的, 有生机的
vibrate	vi. 振动, 颤动, 激动, 摇摆, 踌躇 vt. 使颤动, 使振动, 使摆动
vice	n. 恶习, 恶行, 罪恶, 堕落, 缺陷, 恶癖, 老虎钳 vt. 钳住 prep. 代替
vicinity	n. 附近, 邻近, 附近地区, 近处 [法] 附近, 邻近, 附近地区
vicious	a. 邪恶的, 堕落的, 品性不端的, 恶毒的, 恶性的, 有错误的 [医] 缺点的, 恶的
video	n. 影像, 电视 a. 图像的, 电视的
videos	n. 视频文件；影像资料（video的复数）
videotape	n. 录相磁带 vt. 把电视节目录在录像磁带上
view	n. 视野, 风景, 见解, 视力, 观看, 视图, 指望, 意图, 印象 vt. 看, 考虑, 视察, 查看, 估量 [计] 视图
vigilant	a. 警觉的, 警戒的, 警惕的 [法] 警醒的, 警戒的, 注意的
vigorous	a. 精力充沛的, 元气旺盛的, 茁壮的, 有力的
village	n. 村庄 a. 乡村的, 村庄的
vindicate	vt. 辩护, 证明...无辜, 维护 [法] 辩护, 辩解, 辩明
violate	vt. 违犯, 亵渎, 违反, 侵犯, 妨碍 [经] 违犯, 违反
violent	a. 暴力的, 猛烈的, 激烈的, 极端的, 凶暴的
virtual	a. 实际上起作用的, 虚的, 实质的, 有效的, 事实上生效的 [计] 虚拟
virtually	adv. 事实上
virtuous	a. 品德高尚的, 公正的, 贞洁的, 有效力的
virus	n. 病毒, 滤过性病毒, 毒害 [化] 病毒
visa	n. 签证 vt. 签发
visas	n. 签证( visa的名词复数 )
visible	a. 看得见的, 明显的, 显然的 n. 可见物
visitors	n. 访问者, 游客（visitor 复数）
visual	a. 视觉的 [医] 视觉的, 视力的, 视觉性记忆优势者
visualize	vt. 使看得见, 使具体化, 想象, 设想 vi. 想象, 显形
vital	a. 生命的, 重要的, 充满活力的, 生死攸关的, 致命的 [医] 生命的, 生活的, 生活上必需的, 紧要的
vivid	a. 生动的, 鲜明的, 鲜艳的, 活泼的, 逼真的, 清晰的
vocabulary	n. 词汇(量), 词汇表 [计] 词表
vocation	n. 职业, 天命, 天职, 才能, 行业 [法] 行业, 职业, 职业上的才能
vocational	a. 职业的 [法] 职业上的, 天职的
vogue	n. 时尚, 时髦, 流行 a. 流行的, 时髦的
void	n. 空虚, 空间, 空白, 空隙, 空虚感 a. 空的, 无效的, 无人的, 没有的, 无用的 [计] 脱墨; 空白点
volatile	a. 挥发性的, 可变的, 不稳定的, 飞行的, 轻快的, 爆炸性的 n. 有翅动物, 挥发物 [计] 易失的
volcano	n. 火山
voltage	n. 电压, 伏特数 [化] 电压
volume	n. 册, 卷, 体积, 容量, 大量, 许多, 份量, 音量 vi. 成团卷起 vt. 把...收集成卷 a. 大量的 [计] 卷
voluntary	a. 自动的, 自愿的, 故意的, 志愿的, 自发的 n. 自愿行动, 志愿者, 自由调
volunteer	n. 志愿者 a. 志愿的 v. 自愿
volunteers	n. 义务工作者( volunteer的名词复数 ); 志愿者; 自告奋勇者; 主动做某事的人 v. 自动提供, 自愿效劳( volunteer的第三人称单数 ); 主动建议（或告诉）; （未经当事人同意）举荐; 自愿参军, 当志愿兵
vomit	vt. 吐出, 呕吐 vi. 呕吐 n. 呕吐, 呕吐物, 催吐剂
voucher	n. 证人, 保证人, 证明者, 凭证, 凭单 vt. 证实...的可靠性
vow	n. 誓约, 誓言, 许愿 vi. 起誓, 发誓, 郑重宣言 vt. 立誓, 起誓要, 郑重地宣布
vulgar	a. 粗俗的, 庸俗的, 普通的, 通俗的, 方言的 [法] 庸俗的, 卑下的, 粗俗的
vulnerable	a. 易受伤害的, 有弱点的, 易受影响的, 脆弱的, 成局的 [医] 易损的
wager	n. 赌注, 赌博, 赌物 vt. 下赌注, 向...保证 vi. 打赌
waggon	n. 运货车, 四轮运货马车, (英)铁路货车, 流动服务车, 小型客车, 囚车, 童车
wail	n. 恸哭, 哀号, 嚎啕, 呼啸(声) vi. 恸哭, 呼啸, 悲叹, 哀号, 嚎啕
waiter	n. 侍者
waitress	n. 女侍者, 女服务员
walking	n. 步行, 步态 a. 步行的, 步行用的
wall	n. 墙, 墙壁, 垣, 内壁, 分界物, 屏障 a. 墙的 vt. 给...建墙, 禁闭, 用墙围住 [计] 背景墙
walls	n. 墙壁；墙体（wall的复数）
wander	vi. 游荡, 漫步, 徘徊, 迷路, 离题, 蜿蜒 vt. 在...漫游
wane	n. 减少, 衰微, 败落, 亏缺, 月亏 vi. 变小, 亏缺, 衰落, 消逝, 退潮
ward	n. 病房, 守卫, 保卫, 保护, 监护, 牢房, 行政区, 锁孔内的榫舌 vt. 使入病房, 守护, 保卫
warden	n. 典狱官, 渔猎法监督官, 看守人 [法] 看守人, 监护人, 管理员
wardrobe	n. 衣橱, 衣室, 全部衣服
warehouse	n. 仓库, 货栈, 大商店 vt. 储入仓库
warm	a. 暖和的, 暖的, 温暖的, 热烈的, 兴奋的, 激烈的, 多情的, 色情的 vt. 使温暖, 弄热, 使兴奋, 使充满仇恨 vi. 变暖和, 变温暖, 取暖, 激动, 同情, 爱好 n. 暖, 保暖物
warming	n. 暖和, 加温, 暖热, 温暖, (非正式)打, 鞭打
warranty	n. 正当理由, 授权, 担保, 保证, 根据 [经] 保单, 担保书, 保证书
wary	a. 谨慎的, 小心的, 机警的, 周到的, 唯恐的
washing	n. 洗涤, 浸, 洗涤物 [机] 涂浆, 洗涤
waste	n. 浪费, 废物, 损耗, 消耗, 荒地, 垃圾, 地面风化物 a. 废弃的, 荒芜的, 多余的 vt. 浪费, 消耗, 使荒芜 vi. 浪费, 消耗, 变消瘦
watchdog	n. 看门狗, 监察人 [化] 监控设备; 监视器
water	n. 水, 雨水, 海水, 水位, 水面, 流水 vt. 给...浇水, 供以水, 注入水, 使湿 vi. 流泪, 流口水, 加水 a. 水的, 水上的, 水生的, 含水的
water-clock	n. 水钟, 滴漏
water-proof	[医] 防水的, 不透水的
water-skiing	n. 滑水
waterfall	n. 瀑布
wave	n. 波, 波浪, 波动, 起伏, 高潮, 潮涌, 挥手致意, (气压)突变 vi. 波动, 飘动, 挥手示意, 起伏 vt. 使波动, 使飘扬, 挥舞, 使成波浪形
waver	n. 动摇, 踌躇, 挥动者 vi. 摇摆, 颤抖, 摆动, 摇曳, 犹豫
wax	n. 蜡, 蜡状物, 一阵发怒, 增加, (月亮)渐盈 vi. 变大, 增大, 月亮渐满 vt. 上蜡于
wealth	n. 财富, 资源, 财产, 丰富, 富裕, 大量 [经] 财富
weapon	n. 武器, 兵器 vt. 武装
wear	n. 穿着, 戴, 使用, 耗损, 服装, 耐久性 vt. 穿着, 戴, 留(须、发等), 呈现, 磨损, 磨成, 耗损, 使疲乏, 消磨 vi. 磨损, 变旧, 耐久, 渐变, 渐渐消失
weary	a. 疲倦的, 萎靡的, 厌倦的, 厌烦的 vt. 使疲倦, 使厌烦 vi. 疲乏, 生厌, 不耐烦
weather	n. 天气, 气象, 处境 a. 迎风的 vt. 使受风吹雨打, 侵蚀, 使风化, 经受住 vi. 风化, 受侵蚀, 经受风雨
weave	n. 编法, 织法, 编织式样 vt. 编织, 组合, 编排, 使迂回前进 vi. 纺织, 迂回行进
web	n. 网, 蛛丝, 蹼, 织物, 圈套, 卷筒纸 vi. 结网, 形成网 vt. 织蜘蛛网于, 使落入圈套
website	n. 网站（全球资讯网的主机站）
wedding	n. 婚礼, 结婚, 结婚周年纪念日, 结合 [法] 结婚, 婚礼, 结婚纪念日
wedge	n. 楔子, 楔形物, 起因, 导致分裂的东西 vt. 楔住, 挤进, 楔入 vi. 楔入, 挤进
Wednesday	n. 星期三
weed	n. 杂草, 野草 vi. 除草 vt. 除...的草, 剔除
weeds	n. 丧服
weekdays	adv. 在每个周日, 在平时每天
weekend	n. 周末, 周末休假
weekends	adv. 在每周末
weekly	n. 周刊, 周报 a. 每周的, 一周一次的, 周刊的 adv. 每周, 一周一次
weight	n. 重, 重量, 体重, 砝码, 重大, 影响, 力量 vt. 加重量于, 压迫, 使加权, 称重量 [计] 粗细
weird	a. 怪异的, 超自然的, 不可思议的 n. 命运, 预言, 符咒
weld	n. 焊接处, 焊接 vt. 焊接, 使密接, 使结合, 使成整体 vi. 焊牢
welfare	n. 福利, 安宁, 幸福, 福利事业 a. 福利的
west	n. 西方, 西部 a. 西方的, 向西的 adv. 向西, 自西方, 在西方
western	n. 西方人, 西部片, 西部小说 a. 向西方的, 来自西方的, 西方的, 西洋的, 西部的
westerner	n. 西方人, 西洋人
wetland	n. 湿地, 沼泽地 [经] 湿地
whales	n. 鲸, 鲸鱼( whale的名词复数 )
whatever	pron. 无论什么
wheel	n. 轮子, 车轮, 轮, 方向盘, 旋转, 机构, 重要人物 vt. 使旋转, 转动, 使转向 vi. 旋转, 转弯, 盘旋
wheels	n. 旋转；车轮（wheel的复数）
whereas	conj. 然而, 鉴于 [法] 考虑到, 鉴于, 就...而论
whereby	adv. 靠什么, 如何, 为何, 靠那个, 因此, 由此 [法] 因此, 由是
whilst	conj. 当...的时候, 和...同时, 虽然, 只要, 然而, 而, 尽管
whip	n. 鞭子, 抽打, 车夫, 搅拌器 vt. 鞭打, 搅拌, 煽动, 召集, 仓促制成 vi. 拍击, 急走, 抽打
whirl	n. 回旋, 旋转, 急走, 眩晕 vt. 使旋转, 使回旋, 卷走 vi. 回旋, 旋转, 急走, 发晕
whistle	n. 口哨, 汽笛, 啸啸声, 口哨声 vi. 吹口哨, 鸣汽笛, 发嘘嘘声 vt. 用口哨或吹哨传意, 用口哨演奏
wholesale	n. 批发 a. 批发的, 大规模的 adv. 大规模, 照批发方式 vi. 经营批发业, 批发 vt. 批发
wholesome	a. 有益健康的, 合乎卫生的, 健全的, 有益的, 有生气的, 审慎的
wicked	a. 坏的, 邪恶的, 缺德的, 刻毒的, 恶劣的, 淘气的
wide	a. 宽的, 广阔的, 普遍的, 宽阔的, 广泛的, 一般的 adv. 广阔地, 遍及各处地, 广泛地 n. 大千世界
width	n. 宽度, 宽广, 广博 [医] 宽度
wield	vt. 挥舞, 运用
wilderness	n. 荒野, 荒地, 大量
wildlife	n. 野生动植物
willow	n. 柳树, 柳木制品 a. 柳树的, 柳木制的
wind	n. 风, 气息, 气味, 呼吸, 风声, 趋势, 空谈, 卷绕, 弯曲 vt. 使通风, 嗅出, 使喘气, 吹号角, 上发条, 缠绕, 包, 绞起, 吊起, 使弯曲, 使迂回 vi. 嗅出猎物, 吹响号角, 卷曲, 蜿蜒, 迂回, 缠绕
window	n. 窗户, 窗子, 窗口 vt. 给...开窗 [计] 窗口
wing	n. 翅膀, 翼, 机翼, 派别 vt. 给...装上翼, 飞过, 使飞, 空运, 增加...速度 vi. 飞行
wisdom	n. 智慧, 明智行为, 学识, 名言, 贤人
wise	a. 明智的, 慎虑的, 聪明的, 博学的, 狡猾的, 机灵的 vi. 知道 vt. 教导, 告诉, 劝导 n. 方法, 方式 [计] 教育信息系统
wit	n. 机智, 智力, 头脑, 理智, 妙语, 机智的人
withdraw	vt. 撤回, 取回, 撤消, 使撤退, 拉开, 移开 vi. 撤退, 离开
wither	vt. 使凋谢, 使消亡, 使畏缩 vi. 枯萎, 衰退
withhold	vt. 使停止, 扣留, 保留, 拒给 vi. 克制, 忍住
withstand	vt. 抵住, 顶住, 经得起
witness	n. 证人, 目击者, 证据, 证词 vt. 目击, 作证, 证明, 表明 vi. 作证人, 作为证据
wollongong	伍伦贡[澳大利亚东南部港市]
wood	n. 木材, 木制品 vt. 植林于, 给...添加木柴 vi. 收集木材
woods	n. 森林, 树林
wording	n. 用词, 措词
words	n. 言语；话语；字（word的复数）
worker	n. 工人, 劳动者 [经] 工人, 劳工, 劳动者
working	n. 工作, 运转, 劳动 a. 工作的, 劳动的, 经营的, 抽搐的, 运转的
workload	n. 工作量 [化] 工作量
workshop	n. 工场, 车间, 研讨会 [计] 讨论会; 专题研究组
workshops	n. 专题讨论会( workshop的名词复数 ); 车间; 工作坊; 研究会
world	n. 世界, 地球, 宇宙, 万物, 世人, 人间, 领域, 世事, 世故, 社会生活, 大量 [法] 世界, 地球, 世人
worship	n. 崇拜, 礼拜, 尊敬 vi. 参加礼拜 vt. 崇拜, 尊敬
worthwhile	a. 值得花时间的, 值得做的, 有真实价值的
wrap	n. 外套, 围巾, 包裹物, 限制, 约束, 秘密, 换行 vt. 包装, 卷, 缠绕, 包, 裹, 覆盖, 遮蔽, 隐藏, 掩护 vi. 缠绕, 穿外衣, 包起来 [计] 换行
wreathe	vt. 作成花圈, 环绕, 盘绕, 使笼罩 vi. 扭曲, 成圈, 缭绕
wreck	n. 失事, 残骸, 破坏 vt. 使失事, 拆毁, 破坏 vi. (船)失事, 营救失事船只
wrench	n. 扳钳, 扳手, 扭伤, 歪曲, 痛苦 vt. 猛扭, 扭伤, 曲解, 折磨 vi. 猛扭, 猛绞
wrestle	n. 摔跤, 角力, 扭斗 vi. 摔跤, 搏斗, 斗争, 斟酌 vt. 与(对手)摔跤
wretched	a. 可怜的, 不幸的, 卑鄙的
wrinkle	n. 皱纹, 妙计, 方法, 技巧 vi. 起皱 vt. 使起皱纹
writer	n. 作家, 撰稿者, 抄写员 [化] 记录器
writing	n. 书写, 著作, 笔迹, 作品 [医] 书写
wrought	a. 制成的, 精细的 work的过去式和过去分词
x-ray	a. X射线的 vt. 用X光检查, 照X光 vi. 使用X光
yard	n. 码, 庭院, 工场 [化] 堆置场
yarn	n. 纱, 纱线, 故事 [化] 纱
yawn	n. 哈欠 vi. 打哈欠, 裂开 vt. 打着哈欠说
yearn	vi. 渴望, 想念, 怀念, 同情
yellow	n. 黄色 a. 黄色的
yen	n. 日元(日本货币单位), 渴望, 嗜好 vi. 渴望
yield	n. 生产量, 投资收益 vt. 出产, 给予, 让出, 放弃, 使屈服 vi. 出产, 屈服, 投降, 倒塌
yoga	n. 瑜珈
yoke	n. 轭, 牛轭, 束缚 vt. 给...上轭, 连接, 结合, 使匹配 vi. 结合, 匹配 [计] 磁轭; 磁头组; 偏转线圈
york	n. 约克郡；约克王朝
youngster	n. 小孩, 年轻人, 少年 [法] 儿童, 少年, 青年
youth	n. 年轻, 青年时代, 青年们, 青春 [法] 青年, 青年时期, 青春时期
zero	n. 零, 零点, 零度, 无, 乌有, 最低点 a. 零的, 没有的 vt. 调零, 对(炮火等)作协调校正 [计] 零
zest	n. 兴趣, 热情, 风味, 热心 vt. 给...调味
zoo	n. 动物园
zoology	n. 动物学, 动物区系 [医] 动物学
